fn #,x^2,x,k,root1,root2
1,1,-30,216,-12,-18
2,1,17,0,0,17
3,1,-7,-144,-16,9
4,1,0,-256,-16,16
5,1,-7,-44,4,-11
6,1,-2,-35,5,-7
7,1,-5,-266,14,-19
8,1,12,-133,-7,19
9,1,18,0,18,0
10,1,12,35,5,7
11,1,0,-169,13,-13
12,1,1,-42,-6,7
13,1,5,-234,-13,18
14,1,5,6,3,2
15,1,25,156,12,13
16,1,-36,320,-20,-16
17,1,-38,361,-19,-19
18,1,10,-75,15,-5
19,1,-33,260,-20,-13
20,1,-32,240,-12,-20
21,1,9,-52,13,-4
22,1,-8,7,-1,-7
23,1,-2,-120,10,-12
24,1,2,-224,16,-14
25,1,22,72,4,18
26,1,3,-18,-3,6
27,1,0,-36,6,-6
28,1,-33,260,-13,-20
29,1,21,98,7,14
30,1,-29,190,-19,-10
31,1,20,64,4,16
32,1,-18,0,-18,0
33,1,-36,323,-17,-19
34,1,-2,-24,-6,4
35,1,5,-150,-10,15
36,1,-9,-10,1,-10
37,1,13,30,10,3
38,1,-15,26,-2,-13
39,1,13,42,7,6
40,1,25,144,9,16
41,1,17,30,2,15
42,1,-3,-54,6,-9
43,1,7,-60,12,-5
44,1,-17,30,-15,-2
45,1,-11,-152,-19,8
46,1,-2,-168,12,-14
47,1,-34,285,-19,-15
48,1,27,152,19,8
49,1,0,-289,17,-17
50,1,0,-36,6,-6
51,1,0,-100,-10,10
52,1,-17,66,-6,-11
53,1,10,-96,16,-6
54,1,19,18,1,18
55,1,-5,-126,9,-14
56,1,8,-105,-7,15
57,1,-1,-42,-7,6
58,1,26,169,13,13
59,1,17,72,8,9
60,1,4,-77,11,-7
61,1,18,72,12,6
62,1,3,-154,-11,14
63,1,12,-108,-6,18
64,1,-23,130,-13,-10
65,1,18,72,6,12
66,1,29,198,18,11
67,1,0,-324,-18,18
68,1,9,8,8,1
69,1,-16,0,0,-16
70,1,0,-289,17,-17
71,1,-27,176,-16,-11
72,1,-3,-54,6,-9
73,1,-21,110,-10,-11
74,1,-13,36,-4,-9
75,1,-16,-17,1,-17
76,1,6,-135,-9,15
77,1,-17,60,-5,-12
78,1,-17,60,-5,-12
79,1,0,-16,4,-4
80,1,-24,108,-18,-6
81,1,-16,28,-2,-14
82,1,25,156,12,13
83,1,25,154,14,11
84,1,-14,24,-2,-12
85,1,0,0,0,0
86,1,-11,-180,9,-20
87,1,-17,60,-12,-5
88,1,-22,112,-8,-14
89,1,39,380,19,20
90,1,-2,-195,13,-15
91,1,21,54,3,18
92,1,5,-126,-9,14
93,1,-30,224,-16,-14
94,1,-4,-5,1,-5
95,1,2,-99,-9,11
96,1,6,0,0,6
97,1,24,140,14,10
98,1,13,12,12,1
99,1,14,13,13,1
100,1,17,-38,-2,19
101,1,24,119,7,17
102,1,-7,-170,10,-17
103,1,28,195,13,15
104,1,-16,48,-4,-12
105,1,19,0,19,0
106,1,7,-198,18,-11
107,1,-12,-28,-14,2
108,1,-6,-135,9,-15
109,1,10,24,6,4
110,1,14,-51,17,-3
111,1,-29,210,-15,-14
112,1,9,20,5,4
113,1,-4,0,-4,0
114,1,8,7,7,1
115,1,4,-252,-14,18
116,1,-2,-24,4,-6
117,1,14,-32,16,-2
118,1,9,-220,-11,20
119,1,-28,171,-19,-9
120,1,-4,-165,-15,11
121,1,12,27,9,3
122,1,-14,45,-9,-5
123,1,-2,-15,3,-5
124,1,-33,260,-13,-20
125,1,9,18,3,6
126,1,-30,216,-12,-18
127,1,-9,18,-6,-3
128,1,28,195,13,15
129,1,-6,-216,12,-18
130,1,14,24,2,12
131,1,-6,-72,6,-12
132,1,-7,-30,-10,3
133,1,5,-66,11,-6
134,1,-12,32,-8,-4
135,1,17,-60,-3,20
136,1,-1,-20,-5,4
137,1,11,18,2,9
138,1,-6,-27,3,-9
139,1,-19,34,-2,-17
140,1,32,256,16,16
141,1,-4,3,-1,-3
142,1,37,340,20,17
143,1,10,-96,16,-6
144,1,-9,20,-5,-4
145,1,18,80,10,8
146,1,17,42,3,14
147,1,34,288,16,18
148,1,23,120,8,15
149,1,23,102,6,17
150,1,-2,-24,-6,4
151,1,-11,-12,-12,1
152,1,-21,108,-9,-12
153,1,-15,44,-11,-4
154,1,11,-60,15,-4
155,1,2,-195,-13,15
156,1,-28,180,-10,-18
157,1,-6,-27,-9,3
158,1,-17,42,-3,-14
159,1,0,-64,8,-8
160,1,4,-21,7,-3
161,1,-26,165,-15,-11
162,1,0,-64,8,-8
163,1,-8,-209,11,-19
164,1,6,-247,19,-13
165,1,-7,12,-3,-4
166,1,-2,-195,-15,13
167,1,-24,143,-11,-13
168,1,-1,-20,4,-5
169,1,-6,0,-6,0
170,1,20,84,6,14
171,1,-4,-12,-6,2
172,1,-9,8,-8,-1
173,1,35,306,18,17
174,1,13,-14,-1,14
175,1,23,126,14,9
176,1,28,187,17,11
177,1,-19,88,-11,-8
178,1,9,-52,-4,13
179,1,-10,-119,-17,7
180,1,17,-38,19,-2
181,1,0,-4,2,-2
182,1,4,-12,-2,6
183,1,10,-56,14,-4
184,1,-19,78,-6,-13
185,1,15,36,3,12
186,1,-11,-42,3,-14
187,1,9,0,9,0
188,1,12,11,11,1
189,1,9,-10,-1,10
190,1,9,-36,-3,12
191,1,10,-144,18,-8
192,1,7,-260,-13,20
193,1,-12,-133,-19,7
194,1,-30,216,-18,-12
195,1,3,-304,-16,19
196,1,9,-10,10,-1
197,1,6,-160,16,-10
198,1,0,-64,8,-8
199,1,-1,-20,-5,4
200,1,10,-39,13,-3
201,1,14,0,14,0
202,1,-8,-65,-13,5
203,1,0,-324,18,-18
204,1,-13,0,-13,0
205,1,-5,-6,1,-6
206,1,-18,72,-12,-6
207,1,2,-8,4,-2
208,1,-34,288,-16,-18
209,1,-14,40,-4,-10
210,1,9,-22,11,-2
211,1,3,2,1,2
212,1,6,-27,-3,9
213,1,1,-380,20,-19
214,1,15,56,8,7
215,1,-23,112,-16,-7
216,1,37,342,19,18
217,1,-17,60,-12,-5
218,1,-26,168,-12,-14
219,1,37,342,18,19
220,1,3,0,0,3
221,1,-5,-204,12,-17
222,1,16,60,6,10
223,1,-15,54,-9,-6
224,1,-35,304,-16,-19
225,1,7,-170,-10,17
226,1,1,-30,-5,6
227,1,-3,-70,7,-10
228,1,26,160,10,16
229,1,0,-25,5,-5
230,1,15,36,3,12
231,1,-17,-60,3,-20
232,1,10,0,0,10
233,1,-20,36,-18,-2
234,1,-26,144,-8,-18
235,1,-12,0,0,-12
236,1,36,323,17,19
237,1,16,0,16,0
238,1,2,-3,-1,3
239,1,25,150,10,15
240,1,29,180,9,20
241,1,-1,-380,-20,19
242,1,-14,45,-5,-9
243,1,14,49,7,7
244,1,8,-180,18,-10
245,1,24,143,11,13
246,1,13,-140,20,-7
247,1,15,-76,19,-4
248,1,-2,-8,2,-4
249,1,-14,-120,-20,6
250,1,-3,-154,11,-14
251,1,-5,4,-4,-1
252,1,-19,84,-12,-7
253,1,-1,-2,1,-2
254,1,-16,64,-8,-8
255,1,0,-16,-4,4
256,1,-10,9,-9,-1
257,1,19,90,9,10
258,1,-3,-54,-9,6
259,1,27,182,13,14
260,1,-12,-64,-16,4
261,1,4,-285,-15,19
262,1,-22,120,-10,-12
263,1,-11,-12,-12,1
264,1,-20,84,-6,-14
265,1,-22,57,-19,-3
266,1,21,20,20,1
267,1,11,-102,-6,17
268,1,-22,96,-16,-6
269,1,19,-20,20,-1
270,1,12,20,2,10
271,1,-10,-96,-16,6
272,1,-11,30,-6,-5
273,1,-35,304,-19,-16
274,1,-1,-90,9,-10
275,1,16,55,11,5
276,1,1,-12,-3,4
277,1,-22,117,-13,-9
278,1,-25,150,-15,-10
279,1,29,210,15,14
280,1,12,-85,-5,17
281,1,-10,-56,-14,4
282,1,-16,39,-3,-13
283,1,-28,171,-19,-9
284,1,8,7,1,7
285,1,-4,3,-1,-3
286,1,14,-120,20,-6
287,1,9,18,3,6
288,1,-20,84,-6,-14
289,1,22,121,11,11
290,1,11,18,9,2
291,1,7,-144,-9,16
292,1,4,0,4,0
293,1,-21,80,-5,-16
294,1,4,-252,-14,18
295,1,30,216,12,18
296,1,11,0,0,11
297,1,25,154,14,11
298,1,13,-90,18,-5
299,1,-16,0,0,-16
300,1,37,340,20,17
301,1,-13,-140,-20,7
302,1,6,-7,-1,7
303,1,1,-182,14,-13
304,1,8,-84,14,-6
305,1,-14,24,-2,-12
306,1,-1,-110,10,-11
307,1,7,-120,-8,15
308,1,-33,270,-15,-18
309,1,16,-80,-4,20
310,1,-12,-45,3,-15
311,1,-3,-4,-4,1
312,1,1,-156,13,-12
313,1,-39,380,-19,-20
314,1,26,153,9,17
315,1,18,45,15,3
316,1,8,7,1,7
317,1,13,30,3,10
318,1,-26,168,-12,-14
319,1,8,-20,10,-2
320,1,-21,108,-9,-12
321,1,-11,-126,7,-18
322,1,4,-192,-12,16
323,1,7,6,6,1
324,1,3,-28,7,-4
325,1,18,0,0,18
326,1,-25,156,-12,-13
327,1,-2,-3,-3,1
328,1,-6,-7,1,-7
329,1,-29,204,-17,-12
330,1,-16,60,-6,-10
331,1,-4,-117,9,-13
332,1,21,20,20,1
333,1,-16,-17,-17,1
334,1,24,119,17,7
335,1,16,-36,18,-2
336,1,-16,-36,2,-18
337,1,-4,0,-4,0
338,1,-1,-182,13,-14
339,1,-32,252,-14,-18
340,1,-7,-228,12,-19
341,1,22,105,15,7
342,1,-14,45,-9,-5
343,1,6,-40,-4,10
344,1,-22,117,-9,-13
345,1,-12,-64,-16,4
346,1,-17,-38,2,-19
347,1,-5,-50,-10,5
348,1,8,-65,13,-5
349,1,-3,-304,-19,16
350,1,1,-6,3,-2
351,1,7,12,4,3
352,1,-26,165,-15,-11
353,1,-10,16,-2,-8
354,1,-20,0,0,-20
355,1,25,154,14,11
356,1,-15,-54,3,-18
357,1,-8,-180,10,-18
358,1,24,128,16,8
359,1,10,-96,16,-6
360,1,10,-75,-5,15
361,1,-14,-32,-16,2
362,1,-8,-105,7,-15
363,1,-4,-165,11,-15
364,1,19,-20,-1,20
365,1,7,-260,-13,20
366,1,-6,-216,12,-18
367,1,-22,112,-14,-8
368,1,16,-80,20,-4
369,1,1,-240,16,-15
370,1,-14,-51,3,-17
371,1,-3,-270,-18,15
372,1,3,-28,-4,7
373,1,1,-132,-11,12
374,1,16,15,15,1
375,1,-1,-42,6,-7
376,1,2,-143,-11,13
377,1,-7,6,-6,-1
378,1,2,-323,19,-17
379,1,12,11,11,1
380,1,5,-24,8,-3
381,1,-14,48,-6,-8
382,1,-15,-76,4,-19
383,1,-14,0,-14,0
384,1,-29,198,-11,-18
385,1,-6,-72,-12,6
386,1,-32,255,-15,-17
387,1,19,48,3,16
388,1,-21,68,-4,-17
389,1,-8,-9,-9,1
390,1,8,-153,17,-9
391,1,12,20,10,2
392,1,6,-40,10,-4
393,1,-25,114,-19,-6
394,1,24,119,7,17
395,1,4,-12,-2,6
396,1,34,280,14,20
397,1,-19,78,-13,-6
398,1,40,400,20,20
399,1,15,56,7,8
400,1,30,200,20,10
401,1,21,20,20,1
402,1,1,-156,13,-12
403,1,-25,144,-16,-9
404,1,18,65,13,5
405,1,-5,-66,6,-11
406,1,-31,228,-12,-19
407,1,-19,78,-6,-13
408,1,26,120,6,20
409,1,0,-144,-12,12
410,1,-4,-96,-12,8
411,1,-2,-195,13,-15
412,1,0,-400,-20,20
413,1,-32,247,-13,-19
414,1,9,-10,10,-1
415,1,-7,-170,-17,10
416,1,-14,-120,-20,6
417,1,-2,-168,-14,12
418,1,-12,-108,-18,6
419,1,-31,238,-17,-14
420,1,4,-320,-16,20
421,1,-11,-152,8,-19
422,1,-19,-20,-20,1
423,1,6,-16,-2,8
424,1,-16,48,-4,-12
425,1,24,108,6,18
426,1,7,-30,-3,10
427,1,5,-84,12,-7
428,1,7,-260,-13,20
429,1,-3,-70,-10,7
430,1,-33,260,-20,-13
431,1,-3,-304,-19,16
432,1,14,-15,-1,15
433,1,28,171,9,19
434,1,0,-1,1,-1
435,1,-15,44,-4,-11
436,1,30,224,14,16
437,1,-2,-48,6,-8
438,1,-21,20,-1,-20
439,1,-15,26,-2,-13
440,1,-6,-7,-7,1
441,1,20,84,14,6
442,1,-23,102,-17,-6
443,1,3,-208,16,-13
444,1,11,-180,-9,20
445,1,10,9,9,1
446,1,27,152,8,19
447,1,5,-176,16,-11
448,1,22,96,6,16
449,1,-1,-342,18,-19
450,1,-5,-204,-17,12
451,1,-2,-143,11,-13
452,1,-14,-15,-15,1
453,1,8,7,1,7
454,1,9,-162,18,-9
455,1,23,102,6,17
456,1,-3,-340,-20,17
457,1,-7,-18,2,-9
458,1,-10,21,-7,-3
459,1,3,-340,-17,20
460,1,17,16,1,16
461,1,14,40,4,10
462,1,-19,84,-12,-7
463,1,27,170,10,17
464,1,-21,80,-5,-16
465,1,9,-190,19,-10
466,1,-14,-15,-15,1
467,1,4,-77,-7,11
468,1,-1,-210,14,-15
469,1,19,48,3,16
470,1,1,-380,-19,20
471,1,19,88,8,11
472,1,-30,224,-14,-16
473,1,-3,0,-3,0
474,1,-1,-342,18,-19
475,1,1,-20,5,-4
476,1,21,108,12,9
477,1,0,-25,-5,5
478,1,-9,18,-6,-3
479,1,5,-14,7,-2
480,1,-10,9,-1,-9
481,1,-7,-144,-16,9
482,1,-33,260,-20,-13
483,1,-2,-255,15,-17
484,1,-2,-224,14,-16
485,1,-23,120,-8,-15
486,1,2,-195,15,-13
487,1,-4,-221,13,-17
488,1,12,32,4,8
489,1,16,64,8,8
490,1,40,400,20,20
491,1,3,-40,-5,8
492,1,-20,100,-10,-10
493,1,22,72,4,18
494,1,-1,-72,8,-9
495,1,10,-119,-7,17
496,1,-19,18,-1,-18
497,1,5,-204,17,-12
498,1,30,200,10,20
499,1,34,280,14,20
500,1,-21,38,-2,-19
501,1,-16,-36,-18,2
502,1,-28,192,-16,-12
503,1,-13,36,-4,-9
504,1,19,78,6,13
505,1,7,6,1,6
506,1,10,-56,-4,14
507,1,-17,0,0,-17
508,1,-2,-143,11,-13
509,1,18,81,9,9
510,1,-13,30,-3,-10
511,1,-10,24,-6,-4
512,1,-28,171,-19,-9
513,1,-1,-272,-17,16
514,1,-4,-252,14,-18
515,1,13,40,5,8
516,1,-21,20,-1,-20
517,1,27,170,10,17
518,1,9,-190,19,-10
519,1,-34,280,-20,-14
520,1,-12,11,-1,-11
521,1,-16,0,-16,0
522,1,23,120,8,15
523,1,2,-168,14,-12
524,1,22,105,7,15
525,1,10,-200,20,-10
526,1,14,-72,18,-4
527,1,-7,-8,-8,1
528,1,-3,-28,4,-7
529,1,6,-160,-10,16
530,1,-20,96,-8,-12
531,1,-1,-380,-20,19
532,1,-9,-162,9,-18
533,1,2,0,0,2
534,1,-22,96,-6,-16
535,1,21,110,10,11
536,1,-5,-104,8,-13
537,1,-24,140,-10,-14
538,1,-15,0,0,-15
539,1,-15,44,-11,-4
540,1,-14,33,-3,-11
541,1,16,0,0,16
542,1,35,300,20,15
543,1,-32,255,-15,-17
544,1,-12,32,-8,-4
545,1,-2,-360,-20,18
546,1,-29,204,-17,-12
547,1,-5,6,-2,-3
548,1,12,35,5,7
549,1,-17,30,-15,-2
550,1,-12,35,-5,-7
551,1,-9,-190,-19,10
552,1,0,-16,-4,4
553,1,11,0,0,11
554,1,20,99,9,11
555,1,15,50,5,10
556,1,-11,10,-1,-10
557,1,-3,-270,-18,15
558,1,5,0,0,5
559,1,37,340,20,17
560,1,5,-126,-9,14
561,1,-9,-162,-18,9
562,1,4,-60,10,-6
563,1,-15,26,-13,-2
564,1,0,-100,-10,10
565,1,29,210,15,14
566,1,-4,0,-4,0
567,1,-7,-30,-10,3
568,1,-13,40,-5,-8
569,1,4,-117,13,-9
570,1,-24,119,-7,-17
571,1,29,198,18,11
572,1,7,10,2,5
573,1,-39,380,-20,-19
574,1,16,-57,-3,19
575,1,-20,19,-1,-19
576,1,-15,0,-15,0
577,1,5,-66,-6,11
578,1,-24,128,-8,-16
579,1,-5,-126,-14,9
580,1,-7,-260,-20,13
581,1,19,-20,-1,20
582,1,27,152,19,8
583,1,-15,-34,2,-17
584,1,-22,117,-13,-9
585,1,10,-171,19,-9
586,1,-17,-38,2,-19
587,1,10,-119,17,-7
588,1,12,-133,19,-7
589,1,31,220,11,20
590,1,-28,160,-20,-8
591,1,-26,168,-14,-12
592,1,-30,209,-11,-19
593,1,22,96,16,6
594,1,1,-2,2,-1
595,1,14,-95,-5,19
596,1,-29,180,-9,-20
597,1,31,234,13,18
598,1,3,-238,-14,17
599,1,-4,-252,14,-18
600,1,33,260,13,20
601,1,-24,80,-4,-20
602,1,2,1,1,1
603,1,1,-90,10,-9
604,1,5,-84,12,-7
605,1,-25,154,-14,-11
606,1,-3,-130,-13,10
607,1,-20,75,-15,-5
608,1,-20,36,-18,-2
609,1,-22,120,-10,-12
610,1,-2,-8,2,-4
611,1,-16,-36,2,-18
612,1,-1,-72,8,-9
613,1,11,-180,20,-9
614,1,-12,-108,6,-18
615,1,25,136,17,8
616,1,15,-16,16,-1
617,1,0,-400,-20,20
618,1,-10,-24,-12,2
619,1,13,30,3,10
620,1,-24,108,-18,-6
621,1,-12,36,-6,-6
622,1,-21,104,-13,-8
623,1,-9,-190,10,-19
624,1,-25,154,-11,-14
625,1,-18,0,-18,0
626,1,-7,-78,6,-13
627,1,4,-12,-2,6
628,1,-17,0,-17,0
629,1,-10,-56,-14,4
630,1,-11,-42,3,-14
631,1,-22,72,-18,-4
632,1,-5,-36,-9,4
633,1,33,266,14,19
634,1,9,-36,-3,12
635,1,22,57,19,3
636,1,-18,72,-6,-12
637,1,22,120,12,10
638,1,-7,-170,-17,10
639,1,13,-114,-6,19
640,1,-23,130,-13,-10
641,1,-16,28,-14,-2
642,1,3,-304,-16,19
643,1,-6,-72,-12,6
644,1,-14,-95,-19,5
645,1,13,-48,16,-3
646,1,-14,45,-9,-5
647,1,-4,-140,10,-14
648,1,19,78,6,13
649,1,26,165,11,15
650,1,38,360,20,18
651,1,4,-12,-2,6
652,1,30,200,10,20
653,1,-8,-65,5,-13
654,1,13,22,11,2
655,1,7,-228,-12,19
656,1,-20,0,0,-20
657,1,-27,162,-18,-9
658,1,-7,-18,2,-9
659,1,7,10,2,5
660,1,8,-65,13,-5
661,1,32,240,12,20
662,1,22,96,16,6
663,1,8,12,6,2
664,1,-34,288,-18,-16
665,1,-1,-20,4,-5
666,1,6,-27,-3,9
667,1,-4,4,-2,-2
668,1,-27,152,-8,-19
669,1,-1,-2,-2,1
670,1,12,-13,-1,13
671,1,26,160,16,10
672,1,6,-7,-1,7
673,1,9,-36,12,-3
674,1,8,-9,9,-1
675,1,19,70,14,5
676,1,24,95,19,5
677,1,-12,-85,-17,5
678,1,-3,-130,-13,10
679,1,27,162,18,9
680,1,14,13,1,13
681,1,9,-36,-3,12
682,1,12,27,9,3
683,1,-9,-90,6,-15
684,1,4,-45,-5,9
685,1,31,240,15,16
686,1,24,143,13,11
687,1,-23,130,-10,-13
688,1,4,-165,15,-11
689,1,-1,-56,7,-8
690,1,37,340,17,20
691,1,-2,-8,-4,2
692,1,-3,-208,13,-16
693,1,-12,-108,-18,6
694,1,-20,84,-14,-6
695,1,-25,126,-7,-18
696,1,13,30,10,3
697,1,-10,9,-9,-1
698,1,-27,176,-11,-16
699,1,13,-90,-5,18
700,1,-11,-80,5,-16
701,1,-22,57,-3,-19
702,1,10,21,3,7
703,1,-10,-96,6,-16
704,1,-2,-24,4,-6
705,1,9,0,9,0
706,1,-23,120,-15,-8
707,1,-20,99,-9,-11
708,1,-11,-12,1,-12
709,1,7,-30,10,-3
710,1,-5,4,-4,-1
711,1,2,1,1,1
712,1,-17,72,-8,-9
713,1,10,-56,-4,14
714,1,2,-8,-2,4
715,1,7,-30,-3,10
716,1,-10,16,-2,-8
717,1,-2,-35,5,-7
718,1,-14,0,0,-14
719,1,16,-17,-1,17
720,1,-3,2,-1,-2
721,1,21,108,9,12
722,1,-4,-165,11,-15
723,1,25,154,14,11
724,1,-1,-240,-16,15
725,1,14,0,0,14
726,1,29,190,10,19
727,1,-9,-136,-17,8
728,1,-3,-304,16,-19
729,1,-11,24,-3,-8
730,1,-8,-105,-15,7
731,1,29,210,15,14
732,1,-29,180,-9,-20
733,1,12,-64,16,-4
734,1,20,75,15,5
735,1,-12,20,-10,-2
736,1,6,5,1,5
737,1,5,-266,19,-14
738,1,10,-171,-9,19
739,1,-20,51,-3,-17
740,1,-27,170,-10,-17
741,1,2,-99,11,-9
742,1,2,-35,-5,7
743,1,21,108,9,12
744,1,-12,-64,-16,4
745,1,-1,-132,-12,11
746,1,-8,-33,3,-11
747,1,10,-96,16,-6
748,1,9,0,0,9
749,1,-7,-170,-17,10
750,1,-6,-40,4,-10
751,1,33,270,15,18
752,1,-15,14,-14,-1
753,1,15,54,9,6
754,1,-12,32,-4,-8
755,1,4,-221,17,-13
756,1,-20,91,-13,-7
757,1,-13,0,-13,0
758,1,-14,-95,5,-19
759,1,-17,42,-14,-3
760,1,-14,45,-5,-9
761,1,-22,96,-16,-6
762,1,1,-306,18,-17
763,1,-25,126,-18,-7
764,1,-13,0,0,-13
765,1,37,342,19,18
766,1,-24,95,-5,-19
767,1,-16,-80,4,-20
768,1,31,238,14,17
769,1,35,300,20,15
770,1,-22,117,-13,-9
771,1,-8,7,-7,-1
772,1,-3,-238,-17,14
773,1,11,-60,-4,15
774,1,-4,-165,11,-15
775,1,-4,3,-3,-1
776,1,-5,-14,2,-7
777,1,-35,306,-18,-17
778,1,1,0,1,0
779,1,14,24,2,12
780,1,-16,0,0,-16
781,1,0,-64,-8,8
782,1,18,0,0,18
783,1,22,57,19,3
784,1,-25,126,-18,-7
785,1,24,95,5,19
786,1,31,240,16,15
787,1,-10,-144,-18,8
788,1,11,18,9,2
789,1,26,144,18,8
790,1,3,-108,-9,12
791,1,-37,342,-18,-19
792,1,-12,32,-8,-4
793,1,-26,165,-11,-15
794,1,0,-1,-1,1
795,1,-2,-48,6,-8
796,1,18,17,17,1
797,1,35,304,19,16
798,1,-33,260,-20,-13
799,1,-5,-14,2,-7
800,1,13,-114,19,-6
801,1,-7,-198,-18,11
802,1,20,99,9,11
803,1,-30,225,-15,-15
804,1,23,112,7,16
805,1,-16,64,-8,-8
806,1,-2,-48,6,-8
807,1,24,135,15,9
808,1,-7,-144,9,-16
809,1,-13,-90,5,-18
810,1,-24,128,-16,-8
811,1,-3,-70,7,-10
812,1,4,-21,7,-3
813,1,0,0,0,0
814,1,-25,150,-15,-10
815,1,9,-220,20,-11
816,1,4,-12,-2,6
817,1,-15,-76,4,-19
818,1,-21,54,-18,-3
819,1,35,304,16,19
820,1,17,42,3,14
821,1,28,160,20,8
822,1,-23,76,-19,-4
823,1,7,-120,15,-8
824,1,28,195,15,13
825,1,21,98,14,7
826,1,4,-5,-1,5
827,1,1,-132,12,-11
828,1,9,8,8,1
829,1,31,238,14,17
830,1,-25,150,-15,-10
831,1,11,30,6,5
832,1,-5,-36,-9,4
833,1,12,32,8,4
834,1,3,-54,-6,9
835,1,9,14,2,7
836,1,14,-72,-4,18
837,1,12,35,5,7
838,1,22,85,17,5
839,1,-19,78,-6,-13
840,1,-16,39,-3,-13
841,1,-7,-260,13,-20
842,1,15,0,15,0
843,1,-1,-20,4,-5
844,1,-34,285,-19,-15
845,1,-2,-35,-7,5
846,1,-16,28,-2,-14
847,1,18,72,6,12
848,1,-32,252,-14,-18
849,1,3,-70,10,-7
850,1,-22,112,-8,-14
851,1,-16,64,-8,-8
852,1,12,11,1,11
853,1,11,-26,13,-2
854,1,11,-60,-4,15
855,1,-22,112,-8,-14
856,1,14,45,9,5
857,1,22,120,10,12
858,1,23,102,6,17
859,1,-28,192,-16,-12
860,1,-2,-8,2,-4
861,1,-8,12,-6,-2
862,1,-5,-36,-9,4
863,1,3,-10,5,-2
864,1,-21,80,-16,-5
865,1,-1,-30,5,-6
866,1,3,-70,10,-7
867,1,-18,72,-12,-6
868,1,-18,72,-12,-6
869,1,4,-117,-9,13
870,1,-40,400,-20,-20
871,1,-1,-182,13,-14
872,1,0,-100,10,-10
873,1,-24,140,-10,-14
874,1,-9,0,-9,0
875,1,5,-104,13,-8
876,1,-28,192,-12,-16
877,1,-19,70,-5,-14
878,1,-2,-143,11,-13
879,1,0,-1,-1,1
880,1,4,-96,-8,12
881,1,8,-65,-5,13
882,1,-33,270,-18,-15
883,1,6,-187,17,-11
884,1,24,80,20,4
885,1,16,0,16,0
886,1,-3,0,-3,0
887,1,-36,323,-19,-17
888,1,-14,48,-8,-6
889,1,11,-12,12,-1
890,1,3,-88,-8,11
891,1,11,24,3,8
892,1,17,70,10,7
893,1,-13,0,0,-13
894,1,36,320,16,20
895,1,-10,21,-3,-7
896,1,-12,0,-12,0
897,1,7,-18,9,-2
898,1,23,130,10,13
899,1,9,-112,16,-7
900,1,-4,-192,12,-16
901,1,-33,260,-13,-20
902,1,22,121,11,11
903,1,-17,16,-1,-16
904,1,-4,-252,-18,14
905,1,-33,272,-17,-16
906,1,-3,-88,-11,8
907,1,-6,5,-5,-1
908,1,2,-360,-18,20
909,1,18,65,5,13
910,1,18,80,8,10
911,1,0,-196,-14,14
912,1,-18,0,0,-18
913,1,20,64,4,16
914,1,9,18,6,3
915,1,-6,-27,3,-9
916,1,-15,0,-15,0
917,1,33,260,20,13
918,1,20,64,4,16
919,1,21,68,4,17
920,1,-18,17,-1,-17
921,1,-1,-210,-15,14
922,1,-18,65,-5,-13
923,1,-8,15,-3,-5
924,1,-13,12,-12,-1
925,1,-27,162,-18,-9
926,1,2,-255,-15,17
927,1,19,70,14,5
928,1,-7,-198,11,-18
929,1,23,126,9,14
930,1,-13,30,-3,-10
931,1,11,-180,20,-9
932,1,16,39,13,3
933,1,0,-36,-6,6
934,1,7,-120,-8,15
935,1,3,-304,19,-16
936,1,19,48,3,16
937,1,10,-96,-6,16
938,1,10,-96,-6,16
939,1,1,-306,18,-17
940,1,32,256,16,16
941,1,29,190,19,10
942,1,-21,98,-14,-7
943,1,11,18,9,2
944,1,-11,-126,7,-18
945,1,13,-30,-2,15
946,1,-11,-126,7,-18
947,1,-6,-160,10,-16
948,1,4,3,3,1
949,1,-38,360,-20,-18
950,1,20,84,14,6
951,1,-10,21,-7,-3
952,1,16,63,9,7
953,1,20,96,12,8
954,1,32,255,15,17
955,1,-32,256,-16,-16
956,1,-25,114,-19,-6
957,1,20,75,5,15
958,1,20,36,18,2
959,1,7,-198,18,-11
960,1,12,-108,-6,18
961,1,-3,-154,-14,11
962,1,21,108,12,9
963,1,-6,-7,-7,1
964,1,23,126,14,9
965,1,-25,114,-19,-6
966,1,25,154,14,11
967,1,-12,-160,-20,8
968,1,-18,56,-14,-4
969,1,23,126,14,9
970,1,-13,-90,5,-18
971,1,12,0,0,12
972,1,1,-56,-7,8
973,1,-7,6,-1,-6
974,1,-22,105,-7,-15
975,1,-20,100,-10,-10
976,1,17,52,4,13
977,1,-13,42,-6,-7
978,1,1,-240,-15,16
979,1,-4,-165,-15,11
980,1,38,360,20,18
981,1,7,-18,9,-2
982,1,15,50,5,10
983,1,28,180,10,18
984,1,7,12,3,4
985,1,-7,6,-6,-1
986,1,12,-85,-5,17
987,1,7,-98,14,-7
988,1,-16,28,-14,-2
989,1,-3,-10,2,-5
990,1,-1,0,0,-1
991,1,-19,84,-12,-7
992,1,0,-4,-2,2
993,1,0,-49,7,-7
994,1,9,-136,-8,17
995,1,3,-108,-9,12
996,1,6,-160,-10,16
997,1,-1,-30,-6,5
998,1,-27,182,-14,-13
999,1,-15,-16,-16,1
1000,1,-9,-136,8,-17
1001,1,-8,-209,-19,11
1002,1,1,-30,-5,6
1003,1,-5,-266,-19,14
1004,1,1,-342,19,-18
1005,1,-23,60,-3,-20
1006,1,6,-55,11,-5
1007,1,-9,-190,10,-19
1008,1,12,11,1,11
1009,1,-14,48,-8,-6
1010,1,-9,-162,-18,9
1011,1,-33,266,-19,-14
1012,1,-5,-150,-15,10
1013,1,-25,154,-11,-14
1014,1,-8,-209,11,-19
1015,1,21,98,14,7
1016,1,5,-176,16,-11
1017,1,-11,-80,5,-16
1018,1,7,10,5,2
1019,1,5,-234,-13,18
1020,1,14,-95,19,-5
1021,1,3,-304,-16,19
1022,1,-11,28,-4,-7
1023,1,-22,112,-14,-8
1024,1,24,95,5,19
1025,1,35,304,19,16
1026,1,-7,-78,-13,6
1027,1,-29,180,-20,-9
1028,1,-33,272,-17,-16
1029,1,-25,126,-18,-7
1030,1,-10,16,-2,-8
1031,1,19,48,16,3
1032,1,5,-300,20,-15
1033,1,-8,16,-4,-4
1034,1,-6,-40,4,-10
1035,1,31,240,16,15
1036,1,-2,-143,-13,11
1037,1,3,-270,18,-15
1038,1,9,20,4,5
1039,1,39,380,20,19
1040,1,13,-114,-6,19
1041,1,16,48,4,12
1042,1,-4,3,-1,-3
1043,1,-2,-323,17,-19
1044,1,19,84,12,7
1045,1,-4,-252,-18,14
1046,1,34,285,19,15
1047,1,-6,-7,1,-7
1048,1,-1,-272,-17,16
1049,1,26,160,10,16
1050,1,-18,32,-2,-16
1051,1,15,36,3,12
1052,1,-37,340,-20,-17
1053,1,5,-66,11,-6
1054,1,-18,32,-2,-16
1055,1,-6,-91,7,-13
1056,1,13,12,1,12
1057,1,-5,-50,-10,5
1058,1,11,-26,-2,13
1059,1,5,-150,-10,15
1060,1,-12,-133,7,-19
1061,1,1,-72,9,-8
1062,1,-15,-16,1,-16
1063,1,11,-152,19,-8
1064,1,-3,-10,2,-5
1065,1,-3,-208,13,-16
1066,1,6,-91,-7,13
1067,1,15,54,9,6
1068,1,-27,176,-16,-11
1069,1,-37,340,-17,-20
1070,1,-6,-72,-12,6
1071,1,8,-65,-5,13
1072,1,3,-70,-7,10
1073,1,-6,-135,9,-15
1074,1,-21,54,-18,-3
1075,1,11,-42,14,-3
1076,1,-34,280,-14,-20
1077,1,1,-110,-10,11
1078,1,-31,234,-18,-13
1079,1,2,-15,5,-3
1080,1,26,133,7,19
1081,1,-23,126,-9,-14
1082,1,-28,192,-12,-16
1083,1,24,119,17,7
1084,1,8,12,2,6
1085,1,-12,-13,-13,1
1086,1,27,170,17,10
1087,1,-15,36,-3,-12
1088,1,13,12,12,1
1089,1,-35,300,-20,-15
1090,1,3,-154,-11,14
1091,1,31,234,13,18
1092,1,-2,-48,6,-8
1093,1,-27,162,-9,-18
1094,1,7,-198,-11,18
1095,1,-18,45,-15,-3
1096,1,-29,190,-19,-10
1097,1,-6,-91,7,-13
1098,1,1,-156,13,-12
1099,1,-31,238,-17,-14
1100,1,20,64,4,16
1101,1,-7,-120,-15,8
1102,1,35,300,15,20
1103,1,-23,126,-9,-14
1104,1,16,-57,-3,19
1105,1,-21,110,-10,-11
1106,1,27,170,10,17
1107,1,20,0,20,0
1108,1,1,-210,-14,15
1109,1,18,32,2,16
1110,1,-18,-40,2,-20
1111,1,16,-57,19,-3
1112,1,-23,130,-10,-13
1113,1,15,0,0,15
1114,1,36,320,20,16
1115,1,-3,-130,-13,10
1116,1,22,57,3,19
1117,1,-30,209,-19,-11
1118,1,10,-96,16,-6
1119,1,-26,168,-14,-12
1120,1,17,66,6,11
1121,1,14,0,0,14
1122,1,-22,120,-10,-12
1123,1,18,45,15,3
1124,1,11,28,7,4
1125,1,-13,22,-11,-2
1126,1,1,-90,-9,10
1127,1,-8,-65,-13,5
1128,1,-7,12,-4,-3
1129,1,16,-36,-2,18
1130,1,-20,96,-12,-8
1131,1,14,24,12,2
1132,1,11,-152,19,-8
1133,1,3,-108,12,-9
1134,1,-12,11,-11,-1
1135,1,26,160,16,10
1136,1,3,-180,-12,15
1137,1,-13,30,-3,-10
1138,1,13,0,13,0
1139,1,24,128,16,8
1140,1,-6,-91,-13,7
1141,1,-1,-2,1,-2
1142,1,-19,78,-6,-13
1143,1,-15,-16,1,-16
1144,1,12,-13,13,-1
1145,1,-17,60,-5,-12
1146,1,0,-1,-1,1
1147,1,-13,42,-6,-7
1148,1,-22,72,-4,-18
1149,1,15,50,10,5
1150,1,-29,208,-13,-16
1151,1,-37,340,-20,-17
1152,1,9,-36,-3,12
1153,1,-13,-140,7,-20
1154,1,-5,-36,4,-9
1155,1,-15,-100,-20,5
1156,1,-16,60,-10,-6
1157,1,-22,117,-9,-13
1158,1,9,-220,-11,20
1159,1,-8,-65,5,-13
1160,1,-14,45,-9,-5
1161,1,18,-19,19,-1
1162,1,5,4,1,4
1163,1,6,-7,-1,7
1164,1,19,34,2,17
1165,1,2,-143,-11,13
1166,1,11,-80,16,-5
1167,1,-11,-80,-16,5
1168,1,-8,-33,-11,3
1169,1,18,77,7,11
1170,1,-18,17,-17,-1
1171,1,6,9,3,3
1172,1,-9,-136,8,-17
1173,1,17,-38,-2,19
1174,1,7,-120,-8,15
1175,1,-1,-72,8,-9
1176,1,3,-108,12,-9
1177,1,-10,21,-3,-7
1178,1,-12,-28,2,-14
1179,1,-4,3,-3,-1
1180,1,-31,238,-14,-17
1181,1,-6,-135,9,-15
1182,1,16,63,7,9
1183,1,2,-143,13,-11
1184,1,27,162,18,9
1185,1,7,-198,18,-11
1186,1,-10,-11,1,-11
1187,1,26,153,17,9
1188,1,13,30,3,10
1189,1,-17,-38,-19,2
1190,1,10,0,0,10
1191,1,-20,84,-6,-14
1192,1,26,168,14,12
1193,1,-7,-144,9,-16
1194,1,-18,0,0,-18
1195,1,17,66,6,11
1196,1,-7,-18,2,-9
1197,1,9,8,8,1
1198,1,-20,99,-11,-9
1199,1,2,-360,-18,20
1200,1,18,-40,20,-2
1201,1,-10,25,-5,-5
1202,1,-23,76,-19,-4
1203,1,0,-25,-5,5
1204,1,-2,-168,-14,12
1205,1,-23,132,-11,-12
1206,1,-9,-220,11,-20
1207,1,-29,180,-9,-20
1208,1,-7,12,-3,-4
1209,1,37,340,17,20
1210,1,27,140,7,20
1211,1,-8,-20,2,-10
1212,1,0,-9,-3,3
1213,1,26,144,18,8
1214,1,-17,70,-10,-7
1215,1,-5,-126,9,-14
1216,1,6,-55,11,-5
1217,1,25,114,6,19
1218,1,-1,-90,-10,9
1219,1,-9,-36,-12,3
1220,1,14,45,9,5
1221,1,24,143,11,13
1222,1,-27,170,-17,-10
1223,1,8,-84,-6,14
1224,1,15,-16,-1,16
1225,1,-9,8,-8,-1
1226,1,7,-8,-1,8
1227,1,1,-240,16,-15
1228,1,37,342,18,19
1229,1,13,12,1,12
1230,1,-13,-68,-17,4
1231,1,1,-2,-1,2
1232,1,18,77,7,11
1233,1,19,60,15,4
1234,1,-20,99,-9,-11
1235,1,28,171,9,19
1236,1,-13,36,-9,-4
1237,1,-10,24,-4,-6
1238,1,13,42,6,7
1239,1,13,0,0,13
1240,1,7,12,4,3
1241,1,-1,-42,6,-7
1242,1,21,98,14,7
1243,1,10,-39,-3,13
1244,1,18,72,12,6
1245,1,-33,260,-20,-13
1246,1,22,57,3,19
1247,1,17,66,6,11
1248,1,-27,182,-14,-13
1249,1,-18,-19,1,-19
1250,1,-19,34,-2,-17
1251,1,-32,252,-18,-14
1252,1,-13,-90,-18,5
1253,1,13,40,5,8
1254,1,8,7,7,1
1255,1,2,-120,-10,12
1256,1,-13,-140,-20,7
1257,1,-21,68,-4,-17
1258,1,2,-224,-14,16
1259,1,-9,-112,7,-16
1260,1,-4,-45,5,-9
1261,1,-16,-80,-20,4
1262,1,-3,-270,-18,15
1263,1,26,165,11,15
1264,1,20,99,11,9
1265,1,-20,51,-17,-3
1266,1,7,-44,11,-4
1267,1,-5,0,-5,0
1268,1,35,300,20,15
1269,1,-9,-136,-17,8
1270,1,-32,252,-18,-14
1271,1,30,200,20,10
1272,1,12,-28,14,-2
1273,1,-6,-280,-20,14
1274,1,-7,-18,2,-9
1275,1,-13,-48,-16,3
1276,1,29,190,19,10
1277,1,-16,28,-2,-14
1278,1,10,-96,-6,16
1279,1,6,-247,19,-13
1280,1,24,135,15,9
1281,1,-6,-247,-19,13
1282,1,9,-22,-2,11
1283,1,24,140,14,10
1284,1,-29,190,-19,-10
1285,1,-3,-10,-5,2
1286,1,5,-234,-13,18
1287,1,9,-70,14,-5
1288,1,-21,104,-8,-13
1289,1,7,-44,-4,11
1290,1,-7,-144,9,-16
1291,1,8,-9,-1,9
1292,1,-17,-18,1,-18
1293,1,-36,323,-19,-17
1294,1,-8,-84,6,-14
1295,1,-13,-114,6,-19
1296,1,-11,-102,-17,6
1297,1,12,35,7,5
1298,1,19,0,0,19
1299,1,-9,-112,7,-16
1300,1,11,-80,-5,16
1301,1,1,-56,-7,8
1302,1,10,-119,-7,17
1303,1,-9,-70,-14,5
1304,1,-31,240,-16,-15
1305,1,12,-45,-3,15
1306,1,6,-280,-14,20
1307,1,1,-2,-1,2
1308,1,12,-64,16,-4
1309,1,-9,-52,-13,4
1310,1,-23,130,-10,-13
1311,1,-16,55,-11,-5
1312,1,21,108,9,12
1313,1,16,48,12,4
1314,1,19,78,13,6
1315,1,-5,-84,-12,7
1316,1,-4,-140,-14,10
1317,1,-22,120,-12,-10
1318,1,17,16,16,1
1319,1,-18,80,-10,-8
1320,1,15,14,1,14
1321,1,0,-49,-7,7
1322,1,14,-120,-6,20
1323,1,-14,24,-2,-12
1324,1,1,-20,5,-4
1325,1,-19,48,-3,-16
1326,1,0,-16,-4,4
1327,1,4,-60,-6,10
1328,1,-15,-54,3,-18
1329,1,31,238,14,17
1330,1,-24,140,-14,-10
1331,1,19,88,11,8
1332,1,-3,-4,-4,1
1333,1,16,63,9,7
1334,1,-8,-33,-11,3
1335,1,7,-170,17,-10
1336,1,2,-120,12,-10
1337,1,32,256,16,16
1338,1,24,80,20,4
1339,1,-11,-12,-12,1
1340,1,-27,140,-7,-20
1341,1,-13,42,-7,-6
1342,1,37,340,20,17
1343,1,-19,90,-9,-10
1344,1,13,0,13,0
1345,1,4,-45,-5,9
1346,1,39,380,20,19
1347,1,15,-16,16,-1
1348,1,-28,171,-19,-9
1349,1,-11,-80,5,-16
1350,1,-34,288,-18,-16
1351,1,35,304,19,16
1352,1,-7,-260,13,-20
1353,1,-27,182,-13,-14
1354,1,3,-238,-14,17
1355,1,15,-100,-5,20
1356,1,-26,165,-11,-15
1357,1,6,-7,-1,7
1358,1,-2,-48,6,-8
1359,1,7,-60,12,-5
1360,1,4,-21,7,-3
1361,1,14,-120,20,-6
1362,1,-6,-135,9,-15
1363,1,4,-140,-10,14
1364,1,-2,-360,18,-20
1365,1,12,36,6,6
1366,1,3,-28,-4,7
1367,1,-15,26,-13,-2
1368,1,-22,57,-3,-19
1369,1,15,-54,-3,18
1370,1,27,176,11,16
1371,1,23,130,10,13
1372,1,-17,70,-7,-10
1373,1,2,-143,-11,13
1374,1,7,-30,-3,10
1375,1,23,126,9,14
1376,1,2,-360,20,-18
1377,1,20,96,8,12
1378,1,5,-266,-14,19
1379,1,37,340,17,20
1380,1,25,150,15,10
1381,1,8,12,6,2
1382,1,-10,9,-9,-1
1383,1,-11,10,-10,-1
1384,1,7,-8,-1,8
1385,1,-18,77,-11,-7
1386,1,32,255,15,17
1387,1,-15,44,-11,-4
1388,1,9,-90,-6,15
1389,1,10,-171,19,-9
1390,1,-13,42,-7,-6
1391,1,9,18,3,6
1392,1,-15,14,-1,-14
1393,1,-9,-220,11,-20
1394,1,-4,-32,4,-8
1395,1,-9,-52,-13,4
1396,1,19,18,18,1
1397,1,-6,9,-3,-3
1398,1,10,-200,20,-10
1399,1,28,187,17,11
1400,1,-15,14,-14,-1
1401,1,16,-36,-2,18
1402,1,15,56,8,7
1403,1,4,-5,5,-1
1404,1,-15,-34,2,-17
1405,1,0,-256,-16,16
1406,1,26,165,15,11
1407,1,30,209,11,19
1408,1,11,24,3,8
1409,1,-8,7,-1,-7
1410,1,8,-48,12,-4
1411,1,-3,-28,-7,4
1412,1,39,380,20,19
1413,1,19,90,9,10
1414,1,-1,-110,-11,10
1415,1,25,150,10,15
1416,1,1,-20,-4,5
1417,1,18,56,4,14
1418,1,-7,-170,-17,10
1419,1,1,-156,13,-12
1420,1,2,-15,5,-3
1421,1,16,55,11,5
1422,1,19,90,10,9
1423,1,-1,-272,16,-17
1424,1,-13,-48,-16,3
1425,1,-21,54,-18,-3
1426,1,0,-9,3,-3
1427,1,-3,-340,-20,17
1428,1,-1,-2,1,-2
1429,1,-28,180,-18,-10
1430,1,-34,280,-14,-20
1431,1,-3,-10,2,-5
1432,1,0,-49,-7,7
1433,1,2,-323,-17,19
1434,1,-7,-78,6,-13
1435,1,15,0,15,0
1436,1,10,24,4,6
1437,1,-11,-60,-15,4
1438,1,4,-165,15,-11
1439,1,3,-238,-14,17
1440,1,9,-22,11,-2
1441,1,20,19,19,1
1442,1,11,18,2,9
1443,1,-21,104,-13,-8
1444,1,15,-16,-1,16
1445,1,6,-16,8,-2
1446,1,-19,-20,-20,1
1447,1,37,342,18,19
1448,1,18,80,10,8
1449,1,-31,220,-11,-20
1450,1,27,162,9,18
1451,1,-12,-160,8,-20
1452,1,-23,60,-20,-3
1453,1,-8,15,-5,-3
1454,1,-1,0,0,-1
1455,1,10,-24,12,-2
1456,1,-8,-9,-9,1
1457,1,-26,160,-10,-16
1458,1,6,5,5,1
1459,1,5,-176,16,-11
1460,1,9,18,3,6
1461,1,-7,-144,-16,9
1462,1,2,-120,12,-10
1463,1,28,192,12,16
1464,1,-12,-45,-15,3
1465,1,-9,-22,2,-11
1466,1,-19,48,-16,-3
1467,1,-9,8,-1,-8
1468,1,7,-170,17,-10
1469,1,-22,72,-18,-4
1470,1,11,-42,-3,14
1471,1,-6,8,-4,-2
1472,1,-12,-13,1,-13
1473,1,-3,2,-2,-1
1474,1,-18,56,-14,-4
1475,1,5,-150,-10,15
1476,1,-9,-136,8,-17
1477,1,20,99,11,9
1478,1,18,-40,-2,20
1479,1,-16,55,-5,-11
1480,1,-4,0,0,-4
1481,1,-26,120,-6,-20
1482,1,-21,68,-4,-17
1483,1,-10,-171,-19,9
1484,1,-8,7,-7,-1
1485,1,3,-4,-1,4
1486,1,22,112,8,14
1487,1,10,25,5,5
1488,1,-19,78,-13,-6
1489,1,2,-323,19,-17
1490,1,19,70,5,14
1491,1,5,-50,10,-5
1492,1,-4,-96,-12,8
1493,1,-13,40,-8,-5
1494,1,30,221,17,13
1495,1,-19,48,-3,-16
1496,1,-2,-288,16,-18
1497,1,-12,20,-10,-2
1498,1,-5,4,-1,-4
1499,1,24,119,7,17
1500,1,-30,216,-12,-18
1501,1,-23,132,-11,-12
1502,1,-15,26,-13,-2
1503,1,-21,110,-10,-11
1504,1,-15,26,-13,-2
1505,1,24,140,14,10
1506,1,-13,0,-13,0
1507,1,-34,289,-17,-17
1508,1,2,-15,5,-3
1509,1,-8,-153,9,-17
1510,1,-23,112,-7,-16
1511,1,29,180,20,9
1512,1,7,6,1,6
1513,1,4,3,3,1
1514,1,0,-289,17,-17
1515,1,-27,140,-20,-7
1516,1,-13,-114,-19,6
1517,1,4,-77,11,-7
1518,1,14,-15,-1,15
1519,1,-24,80,-20,-4
1520,1,-4,-96,8,-12
1521,1,3,-208,16,-13
1522,1,-7,-120,8,-15
1523,1,3,-88,-8,11
1524,1,16,60,10,6
1525,1,-19,84,-7,-12
1526,1,22,105,15,7
1527,1,-36,323,-17,-19
1528,1,-20,75,-5,-15
1529,1,16,0,0,16
1530,1,17,70,10,7
1531,1,-12,-28,-14,2
1532,1,-11,-26,-13,2
1533,1,0,-64,8,-8
1534,1,-30,224,-16,-14
1535,1,22,105,7,15
1536,1,2,-15,-3,5
1537,1,2,-120,12,-10
1538,1,28,180,10,18
1539,1,11,-42,14,-3
1540,1,-24,108,-6,-18
1541,1,-11,-42,3,-14
1542,1,-11,0,-11,0
1543,1,-2,-288,16,-18
1544,1,-2,-288,16,-18
1545,1,-10,9,-9,-1
1546,1,11,10,1,10
1547,1,21,80,5,16
1548,1,-13,22,-11,-2
1549,1,-16,60,-6,-10
1550,1,20,96,8,12
1551,1,12,20,2,10
1552,1,6,-72,12,-6
1553,1,12,-160,-8,20
1554,1,-17,72,-9,-8
1555,1,-3,-18,3,-6
1556,1,-3,2,-1,-2
1557,1,-34,285,-15,-19
1558,1,4,-45,9,-5
1559,1,9,-36,12,-3
1560,1,-20,19,-19,-1
1561,1,28,171,19,9
1562,1,-2,-255,15,-17
1563,1,19,78,6,13
1564,1,-1,-30,-6,5
1565,1,-7,0,-7,0
1566,1,-16,-80,4,-20
1567,1,11,28,7,4
1568,1,-1,-156,-13,12
1569,1,-5,-36,4,-9
1570,1,29,204,12,17
1571,1,14,-15,-1,15
1572,1,-31,220,-20,-11
1573,1,-15,44,-4,-11
1574,1,-15,-100,5,-20
1575,1,-16,55,-5,-11
1576,1,21,90,6,15
1577,1,-5,-24,-8,3
1578,1,-2,-288,-18,16
1579,1,-7,-170,-17,10
1580,1,-18,45,-3,-15
1581,1,13,-140,-7,20
1582,1,-15,14,-1,-14
1583,1,-30,200,-20,-10
1584,1,18,56,14,4
1585,1,13,22,2,11
1586,1,0,0,0,0
1587,1,23,102,17,6
1588,1,17,0,17,0
1589,1,-1,-240,15,-16
1590,1,15,-100,-5,20
1591,1,11,0,0,11
1592,1,15,36,3,12
1593,1,5,-150,-10,15
1594,1,-6,-72,6,-12
1595,1,-11,-12,-12,1
1596,1,25,114,6,19
1597,1,-23,120,-15,-8
1598,1,-7,-228,-19,12
1599,1,10,-56,14,-4
1600,1,6,8,2,4
1601,1,2,-24,-4,6
1602,1,9,20,4,5
1603,1,-12,-45,3,-15
1604,1,-22,85,-5,-17
1605,1,-4,-252,14,-18
1606,1,-15,44,-4,-11
1607,1,-21,38,-19,-2
1608,1,27,180,15,12
1609,1,3,-340,-17,20
1610,1,-19,88,-11,-8
1611,1,-3,-208,-16,13
1612,1,17,-60,-3,20
1613,1,-18,17,-17,-1
1614,1,-13,30,-3,-10
1615,1,-25,154,-11,-14
1616,1,-13,-114,-19,6
1617,1,-12,-28,2,-14
1618,1,7,-228,19,-12
1619,1,-22,96,-6,-16
1620,1,31,238,14,17
1621,1,3,-4,-1,4
1622,1,0,-169,-13,13
1623,1,-32,252,-14,-18
1624,1,-7,-30,3,-10
1625,1,31,228,19,12
1626,1,-30,224,-14,-16
1627,1,-12,-133,-19,7
1628,1,5,-266,19,-14
1629,1,29,180,20,9
1630,1,14,33,3,11
1631,1,22,96,16,6
1632,1,-3,-130,10,-13
1633,1,-16,15,-15,-1
1634,1,10,-96,-6,16
1635,1,-30,225,-15,-15
1636,1,-7,-144,-16,9
1637,1,-31,234,-18,-13
1638,1,0,-225,15,-15
1639,1,-30,216,-18,-12
1640,1,-25,144,-16,-9
1641,1,17,52,4,13
1642,1,17,-38,19,-2
1643,1,-2,-8,2,-4
1644,1,7,-98,-7,14
1645,1,4,-5,5,-1
1646,1,-4,-252,14,-18
1647,1,1,-56,8,-7
1648,1,-30,224,-16,-14
1649,1,-18,0,0,-18
1650,1,-17,52,-13,-4
1651,1,-20,64,-4,-16
1652,1,30,224,14,16
1653,1,1,-2,-1,2
1654,1,-1,-210,-15,14
1655,1,-23,76,-19,-4
1656,1,27,176,11,16
1657,1,11,-152,-8,19
1658,1,-22,120,-12,-10
1659,1,-26,153,-9,-17
1660,1,2,-48,-6,8
1661,1,-7,-228,-19,12
1662,1,10,-171,19,-9
1663,1,0,-121,11,-11
1664,1,-16,-17,-17,1
1665,1,-3,-4,-4,1
1666,1,-14,-120,6,-20
1667,1,32,240,12,20
1668,1,-37,340,-17,-20
1669,1,10,-119,17,-7
1670,1,-16,63,-7,-9
1671,1,-18,56,-4,-14
1672,1,-23,130,-10,-13
1673,1,-11,-60,-15,4
1674,1,-5,-6,-6,1
1675,1,-14,40,-10,-4
1676,1,32,255,17,15
1677,1,-16,63,-9,-7
1678,1,-25,154,-11,-14
1679,1,-17,0,-17,0
1680,1,2,-48,8,-6
1681,1,-31,238,-17,-14
1682,1,3,-108,-9,12
1683,1,-6,-247,-19,13
1684,1,11,-152,-8,19
1685,1,-20,51,-17,-3
1686,1,14,-72,-4,18
1687,1,26,168,14,12
1688,1,-22,72,-18,-4
1689,1,-9,-22,2,-11
1690,1,-28,160,-8,-20
1691,1,4,-252,-14,18
1692,1,-2,-255,15,-17
1693,1,-5,-66,6,-11
1694,1,23,76,19,4
1695,1,27,182,14,13
1696,1,-26,165,-11,-15
1697,1,32,255,15,17
1698,1,18,72,6,12
1699,1,-31,228,-19,-12
1700,1,3,-54,9,-6
1701,1,-3,-54,6,-9
1702,1,-7,12,-3,-4
1703,1,9,18,6,3
1704,1,9,-136,17,-8
1705,1,13,36,4,9
1706,1,-23,76,-4,-19
1707,1,-17,-18,1,-18
1708,1,4,-45,9,-5
1709,1,3,-4,4,-1
1710,1,-19,70,-14,-5
1711,1,-8,-180,10,-18
1712,1,-10,-144,-18,8
1713,1,-4,0,-4,0
1714,1,1,-132,12,-11
1715,1,-26,168,-12,-14
1716,1,-16,-36,2,-18
1717,1,3,-28,7,-4
1718,1,-23,76,-4,-19
1719,1,24,140,14,10
1720,1,-21,38,-2,-19
1721,1,-22,96,-16,-6
1722,1,36,320,20,16
1723,1,10,-56,-4,14
1724,1,7,-98,-7,14
1725,1,-27,180,-15,-12
1726,1,7,12,3,4
1727,1,-22,85,-5,-17
1728,1,12,-28,-2,14
1729,1,-6,-216,-18,12
1730,1,7,-18,9,-2
1731,1,-1,-240,15,-16
1732,1,6,-16,8,-2
1733,1,10,-119,-7,17
1734,1,16,0,0,16
1735,1,1,-306,18,-17
1736,1,12,27,9,3
1737,1,-28,180,-18,-10
1738,1,-6,-112,8,-14
1739,1,-14,33,-11,-3
1740,1,-30,224,-14,-16
1741,1,7,-8,-1,8
1742,1,-6,-91,7,-13
1743,1,-14,-32,-16,2
1744,1,23,76,19,4
1745,1,-7,10,-2,-5
1746,1,0,-121,-11,11
1747,1,-28,187,-11,-17
1748,1,-5,4,-4,-1
1749,1,17,0,0,17
1750,1,18,81,9,9
1751,1,13,-30,15,-2
1752,1,12,27,3,9
1753,1,-2,-80,-10,8
1754,1,-12,20,-10,-2
1755,1,6,-7,7,-1
1756,1,-8,-84,-14,6
1757,1,11,-152,19,-8
1758,1,-19,-20,-20,1
1759,1,-32,255,-17,-15
1760,1,-8,-153,-17,9
1761,1,-21,110,-11,-10
1762,1,-1,-342,-19,18
1763,1,0,-49,7,-7
1764,1,-20,75,-5,-15
1765,1,-15,50,-5,-10
1766,1,35,300,20,15
1767,1,-8,-105,7,-15
1768,1,-4,-221,-17,13
1769,1,2,-80,10,-8
1770,1,-2,-255,-17,15
1771,1,32,240,12,20
1772,1,-14,-32,-16,2
1773,1,21,90,15,6
1774,1,4,-96,-8,12
1775,1,9,-90,15,-6
1776,1,23,60,20,3
1777,1,1,-2,-1,2
1778,1,-6,-160,-16,10
1779,1,-4,-221,-17,13
1780,1,4,-221,-13,17
1781,1,27,170,10,17
1782,1,14,33,3,11
1783,1,0,-400,-20,20
1784,1,-6,-7,1,-7
1785,1,10,-119,17,-7
1786,1,-9,-220,11,-20
1787,1,34,288,18,16
1788,1,15,0,0,15
1789,1,14,33,11,3
1790,1,23,90,5,18
1791,1,23,90,18,5
1792,1,-4,-252,-18,14
1793,1,-4,-165,11,-15
1794,1,14,13,1,13
1795,1,-21,110,-10,-11
1796,1,0,-196,-14,14
1797,1,-28,171,-19,-9
1798,1,22,40,2,20
1799,1,8,-209,-11,19
1800,1,-27,170,-17,-10
1801,1,-4,-77,7,-11
1802,1,27,162,9,18
1803,1,-4,-192,-16,12
1804,1,-10,-200,-20,10
1805,1,3,-208,-13,16
1806,1,-21,20,-1,-20
1807,1,-11,-180,-20,9
1808,1,8,15,3,5
1809,1,-21,90,-15,-6
1810,1,-20,91,-13,-7
1811,1,-20,64,-16,-4
1812,1,24,119,17,7
1813,1,-11,24,-3,-8
1814,1,-19,-20,-20,1
1815,1,-2,-24,-6,4
1816,1,5,-84,-7,12
1817,1,-9,-136,8,-17
1818,1,2,-63,9,-7
1819,1,-33,266,-19,-14
1820,1,10,-119,-7,17
1821,1,9,-70,-5,14
1822,1,-2,-15,-5,3
1823,1,20,100,10,10
1824,1,35,300,20,15
1825,1,-3,2,-2,-1
1826,1,3,-180,15,-12
1827,1,-29,208,-13,-16
1828,1,34,289,17,17
1829,1,-16,15,-1,-15
1830,1,5,6,2,3
1831,1,-7,-30,3,-10
1832,1,-6,-247,-19,13
1833,1,-3,-4,-4,1
1834,1,0,-1,-1,1
1835,1,5,-150,-10,15
1836,1,2,-143,-11,13
1837,1,-20,19,-19,-1
1838,1,-5,-176,11,-16
1839,1,-5,-300,15,-20
1840,1,-6,5,-5,-1
1841,1,18,32,16,2
1842,1,20,36,18,2
1843,1,18,56,4,14
1844,1,16,-36,18,-2
1845,1,-17,42,-3,-14
1846,1,24,128,16,8
1847,1,14,-95,19,-5
1848,1,-4,-12,-6,2
1849,1,-13,-14,-14,1
1850,1,1,-72,-8,9
1851,1,1,-380,-19,20
1852,1,-9,18,-6,-3
1853,1,-9,20,-4,-5
1854,1,-27,180,-15,-12
1855,1,18,32,2,16
1856,1,3,-10,-2,5
1857,1,14,-15,-1,15
1858,1,-17,0,-17,0
1859,1,2,-255,17,-15
1860,1,5,-84,12,-7
1861,1,5,-150,15,-10
1862,1,17,70,7,10
1863,1,0,-324,18,-18
1864,1,11,-42,-3,14
1865,1,-27,152,-19,-8
1866,1,-8,-33,3,-11
1867,1,5,-266,19,-14
1868,1,14,0,0,14
1869,1,14,-15,15,-1
1870,1,13,22,2,11
1871,1,-31,220,-20,-11
1872,1,5,-176,-11,16
1873,1,10,-75,-5,15
1874,1,30,216,12,18
1875,1,1,-156,-12,13
1876,1,33,272,16,17
1877,1,21,68,17,4
1878,1,-16,39,-13,-3
1879,1,-19,34,-17,-2
1880,1,19,78,6,13
1881,1,29,198,18,11
1882,1,-14,-15,-15,1
1883,1,16,-80,-4,20
1884,1,6,-55,11,-5
1885,1,23,120,8,15
1886,1,15,-100,20,-5
1887,1,-7,-120,-15,8
1888,1,14,-32,-2,16
1889,1,10,-96,-6,16
1890,1,-11,-26,-13,2
1891,1,3,2,1,2
1892,1,-6,-72,-12,6
1893,1,-6,-187,11,-17
1894,1,15,0,0,15
1895,1,30,209,11,19
1896,1,-8,7,-7,-1
1897,1,15,50,10,5
1898,1,-15,56,-7,-8
1899,1,-5,6,-3,-2
1900,1,4,-60,10,-6
1901,1,14,24,2,12
1902,1,32,255,15,17
1903,1,19,0,0,19
1904,1,-12,35,-7,-5
1905,1,29,210,15,14
1906,1,3,0,3,0
1907,1,15,36,12,3
1908,1,-13,36,-9,-4
1909,1,2,-288,18,-16
1910,1,15,44,11,4
1911,1,16,0,16,0
1912,1,2,-3,3,-1
1913,1,23,132,11,12
1914,1,-34,280,-14,-20
1915,1,-22,117,-13,-9
1916,1,-15,54,-9,-6
1917,1,20,96,8,12
1918,1,-29,204,-17,-12
1919,1,14,-120,-6,20
1920,1,33,270,18,15
1921,1,27,140,20,7
1922,1,7,-260,20,-13
1923,1,-12,20,-2,-10
1924,1,8,0,8,0
1925,1,-3,-180,-15,12
1926,1,-13,-68,4,-17
1927,1,-14,0,-14,0
1928,1,24,135,9,15
1929,1,-14,-120,6,-20
1930,1,-5,-14,2,-7
1931,1,6,-216,-12,18
1932,1,-16,-57,3,-19
1933,1,26,120,6,20
1934,1,14,13,13,1
1935,1,-12,20,-10,-2
1936,1,0,-81,-9,9
1937,1,17,0,17,0
1938,1,-3,-180,12,-15
1939,1,3,-154,-11,14
1940,1,5,-36,-4,9
1941,1,25,150,15,10
1942,1,-25,144,-16,-9
1943,1,-4,-5,-5,1
1944,1,-2,-168,-14,12
1945,1,-14,13,-13,-1
1946,1,3,-54,-6,9
1947,1,19,70,5,14
1948,1,-16,28,-2,-14
1949,1,17,-38,-2,19
1950,1,5,-104,13,-8
1951,1,9,-90,-6,15
1952,1,-4,-320,-20,16
1953,1,-21,108,-9,-12
1954,1,21,98,14,7
1955,1,-31,228,-12,-19
1956,1,4,0,0,4
1957,1,12,11,11,1
1958,1,19,88,8,11
1959,1,22,96,16,6
1960,1,28,195,15,13
1961,1,-31,228,-19,-12
1962,1,-4,-165,-15,11
1963,1,-30,221,-13,-17
1964,1,10,-119,-7,17
1965,1,3,-108,-9,12
1966,1,-26,165,-11,-15
1967,1,6,-187,-11,17
1968,1,-12,-45,-15,3
1969,1,17,-38,19,-2
1970,1,3,-208,-13,16
1971,1,-23,90,-5,-18
1972,1,20,51,3,17
1973,1,21,20,20,1
1974,1,39,380,19,20
1975,1,4,-32,8,-4
1976,1,-16,64,-8,-8
1977,1,7,-144,16,-9
1978,1,-2,-15,-5,3
1979,1,2,-224,16,-14
1980,1,-6,-135,9,-15
1981,1,18,-40,-2,20
1982,1,2,-15,-3,5
1983,1,6,-27,9,-3
1984,1,-11,0,0,-11
1985,1,-6,-16,-8,2
1986,1,16,39,3,13
1987,1,-37,342,-19,-18
1988,1,-2,-323,17,-19
1989,1,-5,-204,-17,12
1990,1,30,200,20,10
1991,1,1,-156,-12,13
1992,1,-14,-72,4,-18
1993,1,-9,-190,10,-19
1994,1,31,234,13,18
1995,1,15,-76,19,-4
1996,1,0,-36,6,-6
1997,1,-27,180,-12,-15
1998,1,-10,-119,-17,7
1999,1,21,20,1,20
2000,1,29,198,11,18
2001,1,-8,7,-1,-7
2002,1,32,247,19,13
2003,1,-1,-110,-11,10
2004,1,-14,24,-2,-12
2005,1,21,108,12,9
2006,1,12,32,8,4
2007,1,-16,15,-1,-15
2008,1,-18,0,-18,0
2009,1,0,-49,-7,7
2010,1,-27,180,-12,-15
2011,1,-21,68,-17,-4
2012,1,-10,25,-5,-5
2013,1,30,225,15,15
2014,1,3,-40,8,-5
2015,1,35,304,16,19
2016,1,22,85,5,17
2017,1,-32,247,-13,-19
2018,1,23,126,14,9
2019,1,0,-64,-8,8
2020,1,5,-176,-11,16
2021,1,-10,-56,-14,4
2022,1,-9,18,-6,-3
2023,1,31,220,20,11
2024,1,17,60,12,5
2025,1,-1,-20,4,-5
2026,1,-9,-22,2,-11
2027,1,-8,0,-8,0
2028,1,21,80,5,16
2029,1,-29,208,-13,-16
2030,1,15,50,5,10
2031,1,26,165,15,11
2032,1,-9,8,-8,-1
2033,1,-20,51,-17,-3
2034,1,3,-208,16,-13
2035,1,9,-220,-11,20
2036,1,-32,247,-19,-13
2037,1,7,-144,16,-9
2038,1,-38,360,-20,-18
2039,1,-4,3,-1,-3
2040,1,-30,225,-15,-15
2041,1,-5,-126,-14,9
2042,1,-13,-90,-18,5
2043,1,37,342,19,18
2044,1,-11,30,-6,-5
2045,1,2,-24,-4,6
2046,1,6,9,3,3
2047,1,-22,121,-11,-11
2048,1,-25,150,-15,-10
2049,1,38,360,18,20
2050,1,-8,-128,-16,8
2051,1,-5,-176,-16,11
2052,1,29,180,9,20
2053,1,13,42,7,6
2054,1,13,22,11,2
2055,1,8,-180,-10,18
2056,1,-8,-105,-15,7
2057,1,22,85,5,17
2058,1,-15,56,-8,-7
2059,1,-3,-304,16,-19
2060,1,29,208,16,13
2061,1,30,209,11,19
2062,1,-8,12,-2,-6
2063,1,-28,192,-12,-16
2064,1,-2,-35,-7,5
2065,1,8,12,2,6
2066,1,37,342,19,18
2067,1,-2,-120,-12,10
2068,1,3,-18,6,-3
2069,1,-7,-198,11,-18
2070,1,1,-132,12,-11
2071,1,5,-66,11,-6
2072,1,-1,-42,6,-7
2073,1,-16,55,-11,-5
2074,1,6,-27,9,-3
2075,1,27,140,20,7
2076,1,15,50,10,5
2077,1,7,0,7,0
2078,1,-1,-132,11,-12
2079,1,-8,-153,-17,9
2080,1,8,16,4,4
2081,1,18,-19,19,-1
2082,1,2,0,0,2
2083,1,2,-120,-10,12
2084,1,17,72,8,9
2085,1,18,-40,20,-2
2086,1,9,-220,-11,20
2087,1,-14,13,-13,-1
2088,1,33,260,13,20
2089,1,0,-225,-15,15
2090,1,-12,-64,4,-16
2091,1,1,-72,-8,9
2092,1,-24,128,-16,-8
2093,1,15,-16,16,-1
2094,1,18,45,15,3
2095,1,-17,-38,-19,2
2096,1,3,-340,-17,20
2097,1,-7,0,0,-7
2098,1,-6,-40,-10,4
2099,1,-5,-234,13,-18
2100,1,-23,60,-20,-3
2101,1,13,40,5,8
2102,1,25,156,13,12
2103,1,23,102,6,17
2104,1,8,-209,-11,19
2105,1,7,6,6,1
2106,1,-36,324,-18,-18
2107,1,10,16,2,8
2108,1,-23,102,-6,-17
2109,1,-6,-247,-19,13
2110,1,19,-20,-1,20
2111,1,-3,-40,5,-8
2112,1,31,220,11,20
2113,1,32,247,13,19
2114,1,-11,10,-10,-1
2115,1,26,133,7,19
2116,1,3,-180,15,-12
2117,1,16,-36,-2,18
2118,1,6,-91,13,-7
2119,1,2,-99,11,-9
2120,1,13,-140,20,-7
2121,1,-13,42,-7,-6
2122,1,30,200,20,10
2123,1,16,60,10,6
2124,1,4,-320,20,-16
2125,1,-8,-240,12,-20
2126,1,30,224,16,14
2127,1,-26,120,-20,-6
2128,1,25,144,9,16
2129,1,4,-192,16,-12
2130,1,-24,140,-14,-10
2131,1,-10,-171,-19,9
2132,1,-31,220,-20,-11
2133,1,-3,-28,4,-7
2134,1,19,34,17,2
2135,1,1,-342,-18,19
2136,1,-19,70,-14,-5
2137,1,4,-140,-10,14
2138,1,-12,-85,-17,5
2139,1,13,-68,-4,17
2140,1,-4,-77,7,-11
2141,1,-10,16,-2,-8
2142,1,15,-16,16,-1
2143,1,-7,-44,-11,4
2144,1,38,360,18,20
2145,1,-5,-6,1,-6
2146,1,-5,-6,-6,1
2147,1,10,-39,13,-3
2148,1,-10,21,-3,-7
2149,1,1,-210,-14,15
2150,1,19,78,13,6
2151,1,5,0,5,0
2152,1,-12,27,-3,-9
2153,1,-2,-80,-10,8
2154,1,-18,72,-6,-12
2155,1,-5,0,0,-5
2156,1,-2,-224,-16,14
2157,1,20,75,15,5
2158,1,7,10,5,2
2159,1,-29,180,-9,-20
2160,1,19,18,18,1
2161,1,23,102,17,6
2162,1,10,9,9,1
2163,1,12,32,4,8
2164,1,7,-30,-3,10
2165,1,17,70,7,10
2166,1,19,34,17,2
2167,1,-23,112,-16,-7
2168,1,-20,36,-18,-2
2169,1,1,-30,6,-5
2170,1,17,66,11,6
2171,1,4,-21,-3,7
2172,1,12,-64,16,-4
2173,1,-4,-32,-8,4
2174,1,-2,-48,-8,6
2175,1,-21,90,-6,-15
2176,1,8,-128,-8,16
2177,1,-36,320,-20,-16
2178,1,-5,-176,11,-16
2179,1,0,-256,16,-16
2180,1,22,40,2,20
2181,1,-13,-48,3,-16
2182,1,15,44,11,4
2183,1,2,-48,-6,8
2184,1,-24,140,-14,-10
2185,1,17,16,16,1
2186,1,-5,-66,6,-11
2187,1,1,-56,-7,8
2188,1,-10,24,-6,-4
2189,1,6,-187,-11,17
2190,1,2,-8,4,-2
2191,1,-1,-72,-9,8
2192,1,-31,220,-11,-20
2193,1,24,108,18,6
2194,1,27,180,15,12
2195,1,-3,-28,4,-7
2196,1,-5,-300,-20,15
2197,1,-9,-22,-11,2
2198,1,1,-6,3,-2
2199,1,-15,50,-10,-5
2200,1,-16,0,-16,0
2201,1,10,0,10,0
2202,1,-10,24,-4,-6
2203,1,-12,-45,-15,3
2204,1,4,-96,12,-8
2205,1,25,100,20,5
2206,1,-9,-220,11,-20
2207,1,-5,-84,-12,7
2208,1,0,-196,-14,14
2209,1,-10,21,-3,-7
2210,1,4,3,1,3
2211,1,26,165,15,11
2212,1,14,-15,-1,15
2213,1,-3,-108,-12,9
2214,1,-3,-180,-15,12
2215,1,-1,-210,14,-15
2216,1,15,26,13,2
2217,1,7,-78,13,-6
2218,1,-11,-42,3,-14
2219,1,-34,280,-20,-14
2220,1,34,288,16,18
2221,1,12,27,3,9
2222,1,14,33,3,11
2223,1,0,-400,-20,20
2224,1,3,-4,-1,4
2225,1,2,-35,-5,7
2226,1,12,-13,-1,13
2227,1,13,-90,-5,18
2228,1,-20,36,-18,-2
2229,1,-13,30,-10,-3
2230,1,-1,-132,-12,11
2231,1,4,-60,10,-6
2232,1,-36,323,-19,-17
2233,1,-23,102,-17,-6
2234,1,11,-152,-8,19
2235,1,-2,-195,13,-15
2236,1,12,-13,13,-1
2237,1,-4,3,-1,-3
2238,1,24,140,10,14
2239,1,-16,-80,4,-20
2240,1,-4,-320,16,-20
2241,1,-13,-90,5,-18
2242,1,9,-10,10,-1
2243,1,-9,18,-6,-3
2244,1,-7,-30,-10,3
2245,1,-30,221,-13,-17
2246,1,1,-272,17,-16
2247,1,16,39,13,3
2248,1,31,238,17,14
2249,1,3,2,2,1
2250,1,12,-133,-7,19
2251,1,-10,-171,-19,9
2252,1,11,24,8,3
2253,1,-14,-51,-17,3
2254,1,30,224,16,14
2255,1,12,-28,-2,14
2256,1,17,60,12,5
2257,1,18,56,4,14
2258,1,6,-135,15,-9
2259,1,1,-110,-10,11
2260,1,37,340,17,20
2261,1,31,240,16,15
2262,1,-30,224,-16,-14
2263,1,0,-121,-11,11
2264,1,-7,-44,-11,4
2265,1,-8,15,-3,-5
2266,1,-3,2,-2,-1
2267,1,5,-66,-6,11
2268,1,22,112,8,14
2269,1,29,190,19,10
2270,1,-26,165,-15,-11
2271,1,5,0,0,5
2272,1,8,-20,10,-2
2273,1,1,-20,5,-4
2274,1,-16,0,0,-16
2275,1,11,-180,20,-9
2276,1,-10,9,-9,-1
2277,1,-18,-19,1,-19
2278,1,-15,54,-9,-6
2279,1,-3,-154,11,-14
2280,1,-37,340,-20,-17
2281,1,22,40,2,20
2282,1,3,-18,-3,6
2283,1,-20,36,-2,-18
2284,1,3,-10,5,-2
2285,1,-1,-306,17,-18
2286,1,-15,-100,-20,5
2287,1,5,-266,-14,19
2288,1,0,-64,-8,8
2289,1,21,68,4,17
2290,1,-11,-126,-18,7
2291,1,12,-160,20,-8
2292,1,-10,21,-3,-7
2293,1,4,-21,7,-3
2294,1,-22,117,-13,-9
2295,1,19,0,19,0
2296,1,16,28,2,14
2297,1,-5,-66,-11,6
2298,1,-12,-45,3,-15
2299,1,29,208,13,16
2300,1,1,-56,8,-7
2301,1,9,18,3,6
2302,1,0,-81,9,-9
2303,1,-16,64,-8,-8
2304,1,-7,-8,-8,1
2305,1,4,-221,17,-13
2306,1,-22,117,-9,-13
2307,1,-18,56,-4,-14
2308,1,-3,-70,7,-10
2309,1,17,30,2,15
2310,1,-6,-135,-15,9
2311,1,-6,-16,2,-8
2312,1,9,-22,11,-2
2313,1,-26,169,-13,-13
2314,1,-35,304,-19,-16
2315,1,-8,-84,6,-14
2316,1,35,300,20,15
2317,1,33,270,18,15
2318,1,10,-39,13,-3
2319,1,3,-208,16,-13
2320,1,-1,0,-1,0
2321,1,-28,160,-20,-8
2322,1,-4,-252,-18,14
2323,1,23,102,6,17
2324,1,-14,33,-3,-11
2325,1,5,-104,-8,13
2326,1,25,100,5,20
2327,1,6,-135,-9,15
2328,1,-9,18,-6,-3
2329,1,14,0,14,0
2330,1,2,-48,8,-6
2331,1,-24,119,-17,-7
2332,1,16,-57,19,-3
2333,1,36,323,17,19
2334,1,-6,0,0,-6
2335,1,-5,-204,12,-17
2336,1,-29,208,-16,-13
2337,1,-15,-76,-19,4
2338,1,15,50,5,10
2339,1,3,-130,-10,13
2340,1,-34,288,-16,-18
2341,1,-1,-210,14,-15
2342,1,-12,-160,-20,8
2343,1,-15,-34,-17,2
2344,1,30,209,11,19
2345,1,6,-16,8,-2
2346,1,0,-81,-9,9
2347,1,9,-136,17,-8
2348,1,-28,196,-14,-14
2349,1,-36,323,-17,-19
2350,1,-17,16,-1,-16
2351,1,2,-143,13,-11
2352,1,4,-77,11,-7
2353,1,-13,-48,-16,3
2354,1,15,-16,16,-1
2355,1,14,33,11,3
2356,1,19,90,10,9
2357,1,-20,0,-20,0
2358,1,-13,30,-3,-10
2359,1,1,-306,18,-17
2360,1,-1,-2,-2,1
2361,1,-3,-208,-16,13
2362,1,-9,-90,-15,6
2363,1,29,210,14,15
2364,1,-10,-39,3,-13
2365,1,-15,54,-9,-6
2366,1,-12,-108,-18,6
2367,1,-5,6,-3,-2
2368,1,3,-10,5,-2
2369,1,-16,15,-15,-1
2370,1,14,-15,-1,15
2371,1,-21,90,-6,-15
2372,1,13,-48,-3,16
2373,1,26,153,9,17
2374,1,12,-108,-6,18
2375,1,-1,-240,15,-16
2376,1,-11,0,0,-11
2377,1,18,77,11,7
2378,1,-8,-180,-18,10
2379,1,-34,280,-14,-20
2380,1,-16,60,-10,-6
2381,1,-17,66,-11,-6
2382,1,30,200,10,20
2383,1,8,7,7,1
2384,1,24,143,11,13
2385,1,5,-204,-12,17
2386,1,13,0,13,0
2387,1,8,-153,-9,17
2388,1,19,0,0,19
2389,1,-34,288,-16,-18
2390,1,-14,48,-6,-8
2391,1,6,-16,8,-2
2392,1,-16,63,-7,-9
2393,1,-2,-3,-3,1
2394,1,3,-208,-13,16
2395,1,-12,-133,7,-19
2396,1,0,-400,20,-20
2397,1,7,-98,14,-7
2398,1,-21,68,-4,-17
2399,1,19,48,16,3
2400,1,19,-20,20,-1
2401,1,9,-10,10,-1
2402,1,-19,48,-3,-16
2403,1,-28,160,-8,-20
2404,1,0,-361,-19,19
2405,1,0,-144,-12,12
2406,1,15,-76,19,-4
2407,1,-16,63,-9,-7
2408,1,-2,-3,1,-3
2409,1,22,72,18,4
2410,1,-2,-24,-6,4
2411,1,-2,-99,9,-11
2412,1,13,22,11,2
2413,1,26,168,14,12
2414,1,2,-63,9,-7
2415,1,-1,-2,1,-2
2416,1,-4,-117,-13,9
2417,1,-24,108,-6,-18
2418,1,12,-13,13,-1
2419,1,13,22,2,11
2420,1,9,-52,-4,13
2421,1,-12,-133,-19,7
2422,1,34,289,17,17
2423,1,3,-88,-8,11
2424,1,4,-60,-6,10
2425,1,1,-156,13,-12
2426,1,13,-30,-2,15
2427,1,-20,19,-1,-19
2428,1,-23,76,-4,-19
2429,1,-32,255,-15,-17
2430,1,-30,224,-16,-14
2431,1,-8,-240,12,-20
2432,1,1,-342,19,-18
2433,1,-38,361,-19,-19
2434,1,-17,42,-3,-14
2435,1,16,-17,-1,17
2436,1,-15,36,-3,-12
2437,1,2,-3,-1,3
2438,1,-12,-108,6,-18
2439,1,-2,-224,-16,14
2440,1,-18,77,-11,-7
2441,1,14,0,0,14
2442,1,11,0,11,0
2443,1,9,0,9,0
2444,1,-7,-30,-10,3
2445,1,19,48,3,16
2446,1,-4,4,-2,-2
2447,1,25,154,14,11
2448,1,26,169,13,13
2449,1,-6,-72,6,-12
2450,1,26,133,19,7
2451,1,-11,-26,2,-13
2452,1,-24,108,-18,-6
2453,1,-3,-180,12,-15
2454,1,-22,105,-15,-7
2455,1,-21,104,-13,-8
2456,1,-7,-120,-15,8
2457,1,10,0,10,0
2458,1,-4,-192,12,-16
2459,1,9,-36,-3,12
2460,1,5,-66,-6,11
2461,1,-30,221,-17,-13
2462,1,14,40,4,10
2463,1,30,216,12,18
2464,1,-23,76,-4,-19
2465,1,-21,54,-18,-3
2466,1,17,30,2,15
2467,1,6,-7,-1,7
2468,1,6,-40,10,-4
2469,1,-12,32,-8,-4
2470,1,-17,30,-2,-15
2471,1,9,18,3,6
2472,1,-5,-150,10,-15
2473,1,9,-70,-5,14
2474,1,17,0,17,0
2475,1,25,150,15,10
2476,1,-9,-220,-20,11
2477,1,23,112,7,16
2478,1,-7,-260,13,-20
2479,1,16,55,5,11
2480,1,15,44,11,4
2481,1,0,0,0,0
2482,1,0,-1,-1,1
2483,1,17,60,5,12
2484,1,7,-18,9,-2
2485,1,15,-34,17,-2
2486,1,-11,28,-4,-7
2487,1,20,64,4,16
2488,1,4,-77,11,-7
2489,1,-13,-90,5,-18
2490,1,-9,-112,7,-16
2491,1,29,210,14,15
2492,1,17,0,0,17
2493,1,9,14,2,7
2494,1,-11,24,-8,-3
2495,1,5,-36,-4,9
2496,1,-14,-95,5,-19
2497,1,1,-56,8,-7
2498,1,21,104,8,13
2499,1,-24,80,-20,-4
2500,1,22,105,15,7
2501,1,-4,-165,11,-15
2502,1,-9,14,-7,-2
2503,1,-26,133,-19,-7
2504,1,9,8,8,1
2505,1,10,9,9,1
2506,1,-7,-44,-11,4
2507,1,11,-26,13,-2
2508,1,-27,152,-8,-19
2509,1,30,221,13,17
2510,1,-10,-39,3,-13
2511,1,12,35,7,5
2512,1,-10,-11,1,-11
2513,1,31,228,12,19
2514,1,29,198,11,18
2515,1,4,-5,5,-1
2516,1,-1,-240,15,-16
2517,1,-15,0,0,-15
2518,1,11,-26,13,-2
2519,1,-1,-20,-5,4
2520,1,26,120,6,20
2521,1,31,220,20,11
2522,1,38,361,19,19
2523,1,-31,228,-12,-19
2524,1,-6,-247,-19,13
2525,1,28,187,17,11
2526,1,13,-30,-2,15
2527,1,-25,126,-7,-18
2528,1,3,-154,-11,14
2529,1,-20,19,-1,-19
2530,1,-16,-80,4,-20
2531,1,-5,-66,6,-11
2532,1,0,-1,1,-1
2533,1,-24,80,-4,-20
2534,1,-25,136,-8,-17
2535,1,7,-8,-1,8
2536,1,0,-324,18,-18
2537,1,6,-72,12,-6
2538,1,-7,12,-3,-4
2539,1,14,40,4,10
2540,1,-20,64,-4,-16
2541,1,-6,-247,-19,13
2542,1,4,-221,17,-13
2543,1,-5,6,-3,-2
2544,1,-6,-72,-12,6
2545,1,-6,5,-5,-1
2546,1,-26,120,-6,-20
2547,1,-3,-340,-20,17
2548,1,9,-136,17,-8
2549,1,8,15,5,3
2550,1,5,-126,-9,14
2551,1,-15,-34,-17,2
2552,1,-18,77,-7,-11
2553,1,10,-119,17,-7
2554,1,-6,-135,9,-15
2555,1,-14,-32,-16,2
2556,1,-5,-126,9,-14
2557,1,-1,-90,9,-10
2558,1,10,0,0,10
2559,1,-36,320,-16,-20
2560,1,-22,105,-7,-15
2561,1,2,-224,-14,16
2562,1,-26,165,-11,-15
2563,1,-19,18,-18,-1
2564,1,-11,-180,9,-20
2565,1,-18,32,-16,-2
2566,1,0,-289,-17,17
2567,1,1,-30,-5,6
2568,1,-23,130,-10,-13
2569,1,15,-76,-4,19
2570,1,-22,112,-8,-14
2571,1,-3,-4,-4,1
2572,1,3,-304,19,-16
2573,1,-3,-130,-13,10
2574,1,0,-4,-2,2
2575,1,-29,198,-18,-11
2576,1,9,-22,-2,11
2577,1,29,180,20,9
2578,1,15,-76,-4,19
2579,1,0,-25,-5,5
2580,1,-6,-40,-10,4
2581,1,-26,168,-14,-12
2582,1,6,-72,-6,12
2583,1,-16,39,-13,-3
2584,1,19,70,14,5
2585,1,-13,-68,4,-17
2586,1,1,-42,7,-6
2587,1,-26,168,-12,-14
2588,1,28,187,11,17
2589,1,16,28,2,14
2590,1,10,-144,18,-8
2591,1,-5,-104,-13,8
2592,1,10,24,6,4
2593,1,-7,-18,-9,2
2594,1,23,76,19,4
2595,1,-7,-44,4,-11
2596,1,-7,10,-5,-2
2597,1,-25,114,-19,-6
2598,1,-21,20,-20,-1
2599,1,-17,-18,1,-18
2600,1,16,64,8,8
2601,1,1,-42,-6,7
2602,1,-8,-9,-9,1
2603,1,4,-77,-7,11
2604,1,-11,-102,6,-17
2605,1,18,32,16,2
2606,1,-14,-32,-16,2
2607,1,-17,52,-13,-4
2608,1,17,42,14,3
2609,1,7,12,3,4
2610,1,11,-180,20,-9
2611,1,-22,112,-8,-14
2612,1,6,-247,19,-13
2613,1,23,76,4,19
2614,1,22,120,12,10
2615,1,-12,36,-6,-6
2616,1,-6,-55,-11,5
2617,1,-20,0,-20,0
2618,1,1,-306,18,-17
2619,1,33,260,20,13
2620,1,14,-120,20,-6
2621,1,-19,78,-13,-6
2622,1,6,-27,9,-3
2623,1,-30,209,-11,-19
2624,1,-6,-40,-10,4
2625,1,-29,180,-9,-20
2626,1,11,-152,19,-8
2627,1,-15,-76,-19,4
2628,1,-19,78,-6,-13
2629,1,-26,160,-16,-10
2630,1,13,-14,-1,14
2631,1,3,-70,10,-7
2632,1,34,285,15,19
2633,1,31,234,13,18
2634,1,-30,224,-16,-14
2635,1,4,-77,11,-7
2636,1,-32,252,-14,-18
2637,1,2,-15,5,-3
2638,1,-23,90,-5,-18
2639,1,-5,6,-3,-2
2640,1,1,-210,15,-14
2641,1,-13,40,-5,-8
2642,1,5,4,1,4
2643,1,-4,-77,-11,7
2644,1,-32,240,-20,-12
2645,1,7,0,7,0
2646,1,9,-70,-5,14
2647,1,16,28,14,2
2648,1,4,-117,-9,13
2649,1,-19,48,-3,-16
2650,1,-4,-21,-7,3
2651,1,20,64,16,4
2652,1,1,-42,-6,7
2653,1,17,30,15,2
2654,1,18,81,9,9
2655,1,7,6,1,6
2656,1,9,-52,13,-4
2657,1,-5,-266,14,-19
2658,1,3,-88,11,-8
2659,1,-6,-27,3,-9
2660,1,-2,-80,-10,8
2661,1,-4,-117,9,-13
2662,1,-17,-18,1,-18
2663,1,35,306,18,17
2664,1,2,-35,7,-5
2665,1,1,-132,-11,12
2666,1,4,-96,12,-8
2667,1,21,110,11,10
2668,1,1,-72,9,-8
2669,1,-23,112,-16,-7
2670,1,10,-200,20,-10
2671,1,26,165,15,11
2672,1,-11,28,-4,-7
2673,1,11,-26,-2,13
2674,1,8,15,5,3
2675,1,16,-36,18,-2
2676,1,-3,-270,15,-18
2677,1,12,-108,-6,18
2678,1,14,0,14,0
2679,1,-14,-72,-18,4
2680,1,-15,14,-14,-1
2681,1,2,0,0,2
2682,1,3,-270,18,-15
2683,1,24,140,10,14
2684,1,-8,-128,-16,8
2685,1,4,-221,17,-13
2686,1,5,6,3,2
2687,1,15,-54,18,-3
2688,1,-2,-360,-20,18
2689,1,-2,-24,4,-6
2690,1,2,-288,18,-16
2691,1,25,114,6,19
2692,1,1,-182,-13,14
2693,1,-3,-238,14,-17
2694,1,6,-112,-8,14
2695,1,4,-96,-8,12
2696,1,-1,0,-1,0
2697,1,-2,1,-1,-1
2698,1,13,-68,17,-4
2699,1,-20,0,0,-20
2700,1,30,200,20,10
2701,1,10,-171,19,-9
2702,1,-1,-56,7,-8
2703,1,-3,-10,-5,2
2704,1,18,17,1,17
2705,1,-9,-10,1,-10
2706,1,-36,320,-20,-16
2707,1,11,0,11,0
2708,1,-5,-176,11,-16
2709,1,-12,-133,7,-19
2710,1,21,110,10,11
2711,1,4,-285,-15,19
2712,1,3,-70,-7,10
2713,1,5,0,0,5
2714,1,-35,300,-15,-20
2715,1,13,-48,16,-3
2716,1,-1,0,-1,0
2717,1,0,-49,7,-7
2718,1,15,-76,-4,19
2719,1,8,-209,-11,19
2720,1,32,255,15,17
2721,1,-2,-15,3,-5
2722,1,-19,88,-11,-8
2723,1,-22,57,-3,-19
2724,1,4,-5,-1,5
2725,1,-17,-18,1,-18
2726,1,29,190,19,10
2727,1,34,288,18,16
2728,1,-9,-22,2,-11
2729,1,-9,-136,8,-17
2730,1,-13,42,-6,-7
2731,1,-30,209,-11,-19
2732,1,13,-90,18,-5
2733,1,-2,-195,-15,13
2734,1,-12,11,-11,-1
2735,1,-19,18,-18,-1
2736,1,-12,36,-6,-6
2737,1,-1,-182,13,-14
2738,1,31,234,18,13
2739,1,0,-81,-9,9
2740,1,12,-160,-8,20
2741,1,4,-285,-15,19
2742,1,-2,-3,1,-3
2743,1,4,-12,-2,6
2744,1,3,-304,19,-16
2745,1,12,27,9,3
2746,1,-6,-40,-10,4
2747,1,-1,-342,-19,18
2748,1,23,102,6,17
2749,1,-14,49,-7,-7
2750,1,-7,-228,-19,12
2751,1,-11,-60,4,-15
2752,1,2,-63,9,-7
2753,1,-20,96,-12,-8
2754,1,23,120,8,15
2755,1,2,-24,-4,6
2756,1,33,270,18,15
2757,1,-17,0,0,-17
2758,1,-1,-20,4,-5
2759,1,-5,-204,12,-17
2760,1,-20,75,-5,-15
2761,1,23,120,15,8
2762,1,8,15,5,3
2763,1,7,-260,20,-13
2764,1,14,49,7,7
2765,1,-6,-91,7,-13
2766,1,1,-12,4,-3
2767,1,0,-1,1,-1
2768,1,9,-190,19,-10
2769,1,-1,-110,-11,10
2770,1,28,171,19,9
2771,1,4,-32,-4,8
2772,1,8,-128,-8,16
2773,1,-34,285,-19,-15
2774,1,9,-22,-2,11
2775,1,-32,255,-15,-17
2776,1,15,50,5,10
2777,1,14,33,3,11
2778,1,4,-252,-14,18
2779,1,-29,208,-13,-16
2780,1,10,-96,16,-6
2781,1,18,72,6,12
2782,1,7,-260,20,-13
2783,1,-29,190,-19,-10
2784,1,-18,-40,2,-20
2785,1,-18,32,-2,-16
2786,1,10,-119,-7,17
2787,1,-33,260,-20,-13
2788,1,-2,-143,11,-13
2789,1,6,-247,19,-13
2790,1,30,221,13,17
2791,1,23,132,12,11
2792,1,8,16,4,4
2793,1,-12,32,-8,-4
2794,1,-12,11,-1,-11
2795,1,-24,108,-18,-6
2796,1,11,-60,-4,15
2797,1,4,-221,17,-13
2798,1,5,-150,15,-10
2799,1,6,-280,20,-14
2800,1,7,10,2,5
2801,1,-2,-168,-14,12
2802,1,-5,6,-2,-3
2803,1,11,-80,-5,16
2804,1,32,247,19,13
2805,1,-30,224,-14,-16
2806,1,-17,-18,-18,1
2807,1,7,-78,13,-6
2808,1,2,-323,19,-17
2809,1,13,-90,18,-5
2810,1,3,-304,19,-16
2811,1,-11,28,-7,-4
2812,1,14,-120,20,-6
2813,1,-24,144,-12,-12
2814,1,-31,234,-13,-18
2815,1,-17,66,-6,-11
2816,1,20,51,3,17
2817,1,-18,17,-1,-17
2818,1,-10,24,-6,-4
2819,1,2,-15,5,-3
2820,1,0,-361,19,-19
2821,1,1,-380,-19,20
2822,1,37,342,18,19
2823,1,-10,-96,6,-16
2824,1,-3,-28,-7,4
2825,1,-21,54,-3,-18
2826,1,-12,32,-4,-8
2827,1,-14,33,-11,-3
2828,1,-1,-12,-4,3
2829,1,18,80,8,10
2830,1,25,144,16,9
2831,1,-12,-45,-15,3
2832,1,2,-99,-9,11
2833,1,19,70,5,14
2834,1,19,90,9,10
2835,1,1,-342,19,-18
2836,1,-18,0,0,-18
2837,1,6,9,3,3
2838,1,15,14,14,1
2839,1,16,15,1,15
2840,1,26,160,16,10
2841,1,9,-22,11,-2
2842,1,17,60,5,12
2843,1,1,-2,2,-1
2844,1,20,99,11,9
2845,1,-25,136,-8,-17
2846,1,0,-16,4,-4
2847,1,22,120,12,10
2848,1,-7,-8,-8,1
2849,1,16,60,6,10
2850,1,-31,228,-19,-12
2851,1,4,-12,6,-2
2852,1,7,12,4,3
2853,1,12,-108,18,-6
2854,1,-1,-90,-10,9
2855,1,-8,-48,4,-12
2856,1,-1,-156,12,-13
2857,1,1,-240,-15,16
2858,1,6,-160,-10,16
2859,1,-25,154,-11,-14
2860,1,25,150,10,15
2861,1,-26,120,-20,-6
2862,1,10,-75,-5,15
2863,1,7,-98,-7,14
2864,1,-10,-119,7,-17
2865,1,10,9,9,1
2866,1,6,-91,-7,13
2867,1,-21,110,-11,-10
2868,1,-25,150,-10,-15
2869,1,15,50,10,5
2870,1,-37,340,-20,-17
2871,1,-2,-99,9,-11
2872,1,5,-204,17,-12
2873,1,-13,40,-8,-5
2874,1,-17,-60,-20,3
2875,1,-24,119,-17,-7
2876,1,-12,-28,2,-14
2877,1,23,120,15,8
2878,1,30,200,10,20
2879,1,-7,-144,9,-16
2880,1,16,15,1,15
2881,1,-15,-76,4,-19
2882,1,8,-84,14,-6
2883,1,-32,255,-15,-17
2884,1,-24,95,-5,-19
2885,1,9,-112,16,-7
2886,1,-15,36,-3,-12
2887,1,1,-380,-19,20
2888,1,14,24,2,12
2889,1,-22,120,-12,-10
2890,1,-5,-150,-15,10
2891,1,-2,-323,-19,17
2892,1,0,-169,13,-13
2893,1,-14,0,0,-14
2894,1,-11,-102,6,-17
2895,1,3,-40,8,-5
2896,1,1,-30,-5,6
2897,1,11,-80,-5,16
2898,1,-12,32,-8,-4
2899,1,25,126,18,7
2900,1,-25,100,-20,-5
2901,1,-4,-45,5,-9
2902,1,4,-285,-15,19
2903,1,6,-16,8,-2
2904,1,-32,240,-20,-12
2905,1,-4,-96,8,-12
2906,1,9,-36,-3,12
2907,1,18,32,2,16
2908,1,14,-15,15,-1
2909,1,17,16,1,16
2910,1,32,240,20,12
2911,1,31,234,18,13
2912,1,33,270,18,15
2913,1,18,0,18,0
2914,1,-7,-18,2,-9
2915,1,-2,-323,-19,17
2916,1,-5,4,-4,-1
2917,1,22,121,11,11
2918,1,-5,-24,3,-8
2919,1,-13,-114,-19,6
2920,1,-8,7,-7,-1
2921,1,18,72,12,6
2922,1,6,-280,20,-14
2923,1,25,100,20,5
2924,1,-8,12,-6,-2
2925,1,27,140,20,7
2926,1,-34,288,-16,-18
2927,1,-10,-24,2,-12
2928,1,2,-120,-10,12
2929,1,16,-36,-2,18
2930,1,-11,18,-2,-9
2931,1,-5,-50,-10,5
2932,1,17,16,16,1
2933,1,0,-324,-18,18
2934,1,-21,110,-11,-10
2935,1,9,8,8,1
2936,1,17,72,8,9
2937,1,-28,187,-17,-11
2938,1,4,-21,-3,7
2939,1,-9,-220,11,-20
2940,1,-1,-110,10,-11
2941,1,11,10,1,10
2942,1,20,99,11,9
2943,1,-39,380,-20,-19
2944,1,14,-51,-3,17
2945,1,3,-70,10,-7
2946,1,5,6,2,3
2947,1,-5,-234,13,-18
2948,1,6,-280,-14,20
2949,1,-3,-10,2,-5
2950,1,-4,-320,16,-20
2951,1,-5,-66,6,-11
2952,1,10,-200,-10,20
2953,1,-8,12,-2,-6
2954,1,-6,-160,10,-16
2955,1,-33,270,-18,-15
2956,1,-4,-12,2,-6
2957,1,-8,-240,-20,12
2958,1,-14,40,-4,-10
2959,1,7,-170,17,-10
2960,1,1,-30,6,-5
2961,1,-15,14,-1,-14
2962,1,-8,-9,-9,1
2963,1,-32,252,-18,-14
2964,1,-7,-98,7,-14
2965,1,-37,340,-17,-20
2966,1,-9,-162,-18,9
2967,1,-28,187,-11,-17
2968,1,26,120,6,20
2969,1,3,-340,-17,20
2970,1,1,-90,-9,10
2971,1,12,-13,-1,13
2972,1,13,-140,-7,20
2973,1,31,234,13,18
2974,1,-11,-102,-17,6
2975,1,-15,44,-4,-11
2976,1,-13,36,-4,-9
2977,1,7,-228,19,-12
2978,1,-2,-80,-10,8
2979,1,28,196,14,14
2980,1,1,-342,19,-18
2981,1,0,-81,-9,9
2982,1,-8,-20,2,-10
2983,1,12,0,12,0
2984,1,18,-19,19,-1
2985,1,6,-187,-11,17
2986,1,-15,56,-8,-7
2987,1,6,-7,7,-1
2988,1,-26,144,-8,-18
2989,1,11,0,11,0
2990,1,-3,-28,4,-7
2991,1,11,24,3,8
2992,1,-10,0,0,-10
2993,1,15,54,6,9
2994,1,31,240,16,15
2995,1,-3,-130,10,-13
2996,1,25,150,15,10
2997,1,-21,104,-13,-8
2998,1,3,-18,6,-3
2999,1,19,48,3,16
3000,1,20,64,16,4
3001,1,-24,140,-10,-14
3002,1,1,-156,13,-12
3003,1,-9,-90,-15,6
3004,1,5,-50,10,-5
3005,1,0,-256,16,-16
3006,1,17,-38,19,-2
3007,1,15,54,6,9
3008,1,25,156,12,13
3009,1,6,-55,11,-5
3010,1,18,-40,20,-2
3011,1,27,176,11,16
3012,1,9,20,4,5
3013,1,-11,18,-2,-9
3014,1,11,-126,18,-7
3015,1,-23,112,-7,-16
3016,1,0,-64,-8,8
3017,1,22,120,10,12
3018,1,13,-90,-5,18
3019,1,-32,247,-13,-19
3020,1,-12,-160,8,-20
3021,1,-7,-228,12,-19
3022,1,-23,76,-4,-19
3023,1,16,55,11,5
3024,1,26,168,12,14
3025,1,16,-80,20,-4
3026,1,22,120,10,12
3027,1,5,-266,19,-14
3028,1,1,-6,-2,3
3029,1,15,14,1,14
3030,1,-7,-30,-10,3
3031,1,22,105,7,15
3032,1,29,208,13,16
3033,1,-20,51,-17,-3
3034,1,16,-17,17,-1
3035,1,-27,182,-14,-13
3036,1,-12,-13,-13,1
3037,1,-22,96,-16,-6
3038,1,-24,95,-5,-19
3039,1,-13,12,-12,-1
3040,1,-6,-7,1,-7
3041,1,4,-221,-13,17
3042,1,-7,0,0,-7
3043,1,9,-220,20,-11
3044,1,-2,-168,-14,12
3045,1,16,-57,-3,19
3046,1,16,-57,-3,19
3047,1,-12,35,-7,-5
3048,1,21,68,17,4
3049,1,-25,150,-15,-10
3050,1,3,2,2,1
3051,1,15,50,10,5
3052,1,-23,126,-14,-9
3053,1,-2,-80,-10,8
3054,1,-3,-154,-14,11
3055,1,22,117,13,9
3056,1,27,162,9,18
3057,1,-32,252,-14,-18
3058,1,2,-255,17,-15
3059,1,15,0,0,15
3060,1,-8,-240,12,-20
3061,1,9,-112,16,-7
3062,1,6,-16,-2,8
3063,1,2,-48,-6,8
3064,1,22,117,9,13
3065,1,14,33,11,3
3066,1,2,-35,7,-5
3067,1,7,-44,-4,11
3068,1,-14,33,-3,-11
3069,1,36,320,20,16
3070,1,5,0,5,0
3071,1,-9,-90,6,-15
3072,1,7,6,6,1
3073,1,8,-105,15,-7
3074,1,10,-24,12,-2
3075,1,-18,45,-15,-3
3076,1,30,225,15,15
3077,1,14,45,9,5
3078,1,25,126,18,7
3079,1,18,17,1,17
3080,1,-23,120,-15,-8
3081,1,-12,0,-12,0
3082,1,-13,40,-8,-5
3083,1,-13,40,-8,-5
3084,1,17,42,14,3
3085,1,10,-39,-3,13
3086,1,-2,-288,-18,16
3087,1,31,228,12,19
3088,1,6,-7,7,-1
3089,1,7,-260,-13,20
3090,1,4,-12,6,-2
3091,1,14,13,13,1
3092,1,-23,120,-15,-8
3093,1,-10,-200,10,-20
3094,1,16,-80,20,-4
3095,1,-3,-304,-19,16
3096,1,11,0,0,11
3097,1,7,-260,20,-13
3098,1,20,100,10,10
3099,1,-7,-170,-17,10
3100,1,-22,112,-14,-8
3101,1,-1,-20,4,-5
3102,1,-5,-266,-19,14
3103,1,-7,0,0,-7
3104,1,-10,0,0,-10
3105,1,-6,-216,-18,12
3106,1,-3,-108,-12,9
3107,1,-13,40,-5,-8
3108,1,6,-40,-4,10
3109,1,-29,180,-20,-9
3110,1,-37,342,-19,-18
3111,1,7,10,5,2
3112,1,26,144,8,18
3113,1,24,135,15,9
3114,1,-7,-260,13,-20
3115,1,7,-144,16,-9
3116,1,4,-32,8,-4
3117,1,20,96,8,12
3118,1,-22,72,-18,-4
3119,1,-8,-84,-14,6
3120,1,5,-36,-4,9
3121,1,2,-99,-9,11
3122,1,2,-143,13,-11
3123,1,6,-216,18,-12
3124,1,-7,-120,-15,8
3125,1,-6,-187,-17,11
3126,1,7,-170,17,-10
3127,1,-10,0,-10,0
3128,1,-3,-108,9,-12
3129,1,-16,63,-9,-7
3130,1,2,-323,-17,19
3131,1,18,45,15,3
3132,1,16,15,15,1
3133,1,-34,289,-17,-17
3134,1,21,80,5,16
3135,1,-8,-128,-16,8
3136,1,-10,-11,-11,1
3137,1,-3,-154,-14,11
3138,1,-12,-133,-19,7
3139,1,2,-120,-10,12
3140,1,27,176,11,16
3141,1,-3,-108,9,-12
3142,1,0,-400,-20,20
3143,1,-4,0,0,-4
3144,1,-16,48,-12,-4
3145,1,-12,-64,-16,4
3146,1,-8,-48,4,-12
3147,1,-37,340,-17,-20
3148,1,-8,15,-5,-3
3149,1,-1,-380,19,-20
3150,1,4,-32,-4,8
3151,1,10,21,7,3
3152,1,-9,18,-6,-3
3153,1,-28,192,-12,-16
3154,1,8,-84,-6,14
3155,1,11,0,0,11
3156,1,-17,42,-14,-3
3157,1,-5,-234,13,-18
3158,1,-11,24,-8,-3
3159,1,-5,-14,2,-7
3160,1,28,171,9,19
3161,1,8,15,5,3
3162,1,-16,-17,1,-17
3163,1,-8,12,-2,-6
3164,1,2,-255,-15,17
3165,1,36,323,19,17
3166,1,7,-120,-8,15
3167,1,-20,51,-3,-17
3168,1,13,22,2,11
3169,1,19,88,11,8
3170,1,0,-1,-1,1
3171,1,37,340,20,17
3172,1,3,-10,5,-2
3173,1,-30,216,-18,-12
3174,1,15,0,15,0
3175,1,-4,-221,13,-17
3176,1,-18,17,-1,-17
3177,1,-23,132,-12,-11
3178,1,-2,-195,13,-15
3179,1,-6,-91,7,-13
3180,1,4,-32,-4,8
3181,1,20,51,3,17
3182,1,-21,20,-1,-20
3183,1,2,-195,15,-13
3184,1,-31,220,-11,-20
3185,1,-27,152,-8,-19
3186,1,4,-192,-12,16
3187,1,-16,60,-10,-6
3188,1,16,28,2,14
3189,1,-8,-33,-11,3
3190,1,1,-56,-7,8
3191,1,11,-180,-9,20
3192,1,30,224,14,16
3193,1,21,104,8,13
3194,1,-5,-36,-9,4
3195,1,4,-21,7,-3
3196,1,-14,24,-12,-2
3197,1,10,-96,-6,16
3198,1,22,117,9,13
3199,1,17,-18,-1,18
3200,1,8,-105,15,-7
3201,1,-15,-34,-17,2
3202,1,9,-10,10,-1
3203,1,-12,-13,-13,1
3204,1,4,-45,9,-5
3205,1,15,56,8,7
3206,1,-32,252,-14,-18
3207,1,-7,-98,-14,7
3208,1,22,85,17,5
3209,1,-20,75,-15,-5
3210,1,20,64,4,16
3211,1,-17,16,-1,-16
3212,1,27,176,16,11
3213,1,29,198,11,18
3214,1,17,66,11,6
3215,1,-24,95,-5,-19
3216,1,8,-65,13,-5
3217,1,-6,-160,-16,10
3218,1,1,-210,-14,15
3219,1,2,-15,-3,5
3220,1,30,209,19,11
3221,1,-22,105,-15,-7
3222,1,7,-18,-2,9
3223,1,-30,224,-16,-14
3224,1,24,140,14,10
3225,1,-3,-108,-12,9
3226,1,35,300,15,20
3227,1,3,-208,16,-13
3228,1,-11,-152,8,-19
3229,1,-1,-156,12,-13
3230,1,5,-14,7,-2
3231,1,32,255,17,15
3232,1,-8,-128,-16,8
3233,1,-13,-140,-20,7
3234,1,-12,0,0,-12
3235,1,12,11,1,11
3236,1,-3,-54,6,-9
3237,1,-9,20,-5,-4
3238,1,-5,-234,-18,13
3239,1,18,17,1,17
3240,1,3,-270,-15,18
3241,1,11,-126,-7,18
3242,1,-8,-105,-15,7
3243,1,-1,-90,-10,9
3244,1,18,-19,-1,19
3245,1,-7,12,-4,-3
3246,1,-8,-9,-9,1
3247,1,8,7,7,1
3248,1,35,304,16,19
3249,1,-20,19,-1,-19
3250,1,7,-60,12,-5
3251,1,2,-195,-13,15
3252,1,-1,-12,-4,3
3253,1,0,0,0,0
3254,1,33,266,19,14
3255,1,-26,133,-7,-19
3256,1,12,20,10,2
3257,1,-19,18,-18,-1
3258,1,10,-171,-9,19
3259,1,11,-12,12,-1
3260,1,9,-70,-5,14
3261,1,22,57,19,3
3262,1,8,-128,-8,16
3263,1,-12,0,0,-12
3264,1,-9,0,0,-9
3265,1,16,48,4,12
3266,1,-28,196,-14,-14
3267,1,-27,176,-16,-11
3268,1,3,-28,-4,7
3269,1,-24,80,-20,-4
3270,1,15,-54,-3,18
3271,1,0,-1,1,-1
3272,1,14,-32,16,-2
3273,1,-3,-18,3,-6
3274,1,0,-4,-2,2
3275,1,0,-1,1,-1
3276,1,27,162,18,9
3277,1,0,-100,10,-10
3278,1,2,-35,-5,7
3279,1,13,-14,-1,14
3280,1,1,-156,-12,13
3281,1,29,180,9,20
3282,1,29,204,17,12
3283,1,6,-280,20,-14
3284,1,17,42,14,3
3285,1,24,119,7,17
3286,1,2,-35,7,-5
3287,1,-3,-40,5,-8
3288,1,2,-143,-11,13
3289,1,-25,100,-20,-5
3290,1,5,-266,19,-14
3291,1,-3,-10,2,-5
3292,1,6,-187,17,-11
3293,1,-20,0,0,-20
3294,1,18,77,7,11
3295,1,-31,234,-13,-18
3296,1,-25,150,-15,-10
3297,1,21,108,9,12
3298,1,27,170,17,10
3299,1,-24,80,-4,-20
3300,1,18,80,8,10
3301,1,-21,54,-3,-18
3302,1,15,-76,19,-4
3303,1,27,152,8,19
3304,1,-13,-68,4,-17
3305,1,21,80,16,5
3306,1,9,-52,13,-4
3307,1,-31,240,-16,-15
3308,1,-16,0,-16,0
3309,1,-38,360,-18,-20
3310,1,13,36,9,4
3311,1,18,77,7,11
3312,1,1,-110,11,-10
3313,1,-3,-18,-6,3
3314,1,-21,110,-10,-11
3315,1,6,5,1,5
3316,1,-32,240,-12,-20
3317,1,22,72,18,4
3318,1,16,28,2,14
3319,1,0,-289,17,-17
3320,1,-16,60,-6,-10
3321,1,20,0,0,20
3322,1,-9,-52,4,-13
3323,1,-5,6,-2,-3
3324,1,7,-18,-2,9
3325,1,5,4,4,1
3326,1,-3,-54,-9,6
3327,1,16,-57,19,-3
3328,1,9,-112,16,-7
3329,1,-25,136,-8,-17
3330,1,27,176,16,11
3331,1,11,-26,13,-2
3332,1,21,68,17,4
3333,1,3,-130,-10,13
3334,1,-3,-304,16,-19
3335,1,-15,0,-15,0
3336,1,14,48,6,8
3337,1,9,-90,15,-6
3338,1,-25,150,-10,-15
3339,1,-11,24,-3,-8
3340,1,-2,-224,14,-16
3341,1,-5,6,-2,-3
3342,1,-36,323,-17,-19
3343,1,31,220,11,20
3344,1,-5,-84,7,-12
3345,1,-8,-48,-12,4
3346,1,-24,95,-19,-5
3347,1,9,-112,-7,16
3348,1,10,16,2,8
3349,1,17,-38,19,-2
3350,1,-7,-198,-18,11
3351,1,-15,50,-10,-5
3352,1,15,-54,18,-3
3353,1,16,-17,17,-1
3354,1,-20,91,-7,-13
3355,1,9,-36,12,-3
3356,1,-15,54,-9,-6
3357,1,-8,-84,-14,6
3358,1,3,-180,-12,15
3359,1,-1,-30,-6,5
3360,1,-7,10,-5,-2
3361,1,17,-60,-3,20
3362,1,9,-70,14,-5
3363,1,22,40,2,20
3364,1,9,0,0,9
3365,1,4,-32,-4,8
3366,1,6,-280,20,-14
3367,1,-12,-28,-14,2
3368,1,-31,220,-11,-20
3369,1,13,-68,17,-4
3370,1,25,114,19,6
3371,1,-12,27,-9,-3
3372,1,7,-170,17,-10
3373,1,-23,112,-7,-16
3374,1,5,-84,-7,12
3375,1,-12,-28,-14,2
3376,1,17,16,16,1
3377,1,6,-7,7,-1
3378,1,-7,0,-7,0
3379,1,-2,-48,-8,6
3380,1,16,-36,18,-2
3381,1,5,-24,-3,8
3382,1,-6,-280,-20,14
3383,1,24,80,20,4
3384,1,-15,14,-1,-14
3385,1,-24,143,-11,-13
3386,1,-27,176,-16,-11
3387,1,19,78,6,13
3388,1,-5,-204,12,-17
3389,1,-15,14,-1,-14
3390,1,3,-270,-15,18
3391,1,2,-195,-13,15
3392,1,-6,-40,4,-10
3393,1,14,-51,-3,17
3394,1,-1,0,0,-1
3395,1,11,-12,12,-1
3396,1,-8,-84,6,-14
3397,1,-7,12,-3,-4
3398,1,-17,60,-5,-12
3399,1,-6,-16,-8,2
3400,1,-13,42,-7,-6
3401,1,-38,360,-20,-18
3402,1,-2,0,-2,0
3403,1,7,-60,-5,12
3404,1,0,-400,-20,20
3405,1,8,12,6,2
3406,1,22,57,3,19
3407,1,-31,238,-17,-14
3408,1,6,-27,-3,9
3409,1,12,20,2,10
3410,1,35,300,15,20
3411,1,-12,-13,-13,1
3412,1,2,-168,14,-12
3413,1,1,-42,-6,7
3414,1,12,-133,19,-7
3415,1,23,90,5,18
3416,1,-3,-108,-12,9
3417,1,-20,84,-6,-14
3418,1,-20,19,-19,-1
3419,1,-11,-60,4,-15
3420,1,-4,-165,11,-15
3421,1,-35,306,-18,-17
3422,1,-34,280,-14,-20
3423,1,3,-28,-4,7
3424,1,-1,-90,-10,9
3425,1,12,-45,15,-3
3426,1,-12,-85,-17,5
3427,1,-10,-75,5,-15
3428,1,13,-14,14,-1
3429,1,-19,84,-7,-12
3430,1,-23,120,-15,-8
3431,1,-21,54,-18,-3
3432,1,21,20,1,20
3433,1,17,52,13,4
3434,1,13,40,8,5
3435,1,12,-45,15,-3
3436,1,-9,-22,-11,2
3437,1,4,-77,11,-7
3438,1,15,0,0,15
3439,1,-32,252,-14,-18
3440,1,-3,-304,16,-19
3441,1,14,45,5,9
3442,1,16,0,16,0
3443,1,-16,60,-6,-10
3444,1,-11,-12,-12,1
3445,1,5,-176,-11,16
3446,1,-10,16,-8,-2
3447,1,-21,108,-9,-12
3448,1,7,12,3,4
3449,1,19,-20,20,-1
3450,1,-11,-180,-20,9
3451,1,7,0,0,7
3452,1,-1,-156,-13,12
3453,1,18,32,2,16
3454,1,0,-100,-10,10
3455,1,-16,39,-3,-13
3456,1,-20,19,-19,-1
3457,1,14,48,8,6
3458,1,-25,154,-11,-14
3459,1,1,-20,5,-4
3460,1,0,-361,-19,19
3461,1,-2,-80,8,-10
3462,1,-16,55,-11,-5
3463,1,22,72,18,4
3464,1,0,-196,-14,14
3465,1,-6,-72,-12,6
3466,1,30,200,10,20
3467,1,-4,4,-2,-2
3468,1,0,-121,-11,11
3469,1,-15,14,-1,-14
3470,1,25,144,9,16
3471,1,28,192,12,16
3472,1,12,35,5,7
3473,1,11,-102,17,-6
3474,1,-7,-228,-19,12
3475,1,2,-195,15,-13
3476,1,-16,-57,3,-19
3477,1,-9,-36,-12,3
3478,1,3,-180,-12,15
3479,1,-14,40,-4,-10
3480,1,-5,4,-1,-4
3481,1,-5,-14,2,-7
3482,1,-11,-42,3,-14
3483,1,12,-64,-4,16
3484,1,-10,-39,-13,3
3485,1,-9,-70,5,-14
3486,1,9,-52,-4,13
3487,1,-24,119,-17,-7
3488,1,-32,252,-18,-14
3489,1,-37,340,-20,-17
3490,1,-6,-160,-16,10
3491,1,-17,60,-12,-5
3492,1,14,33,3,11
3493,1,-10,-75,-15,5
3494,1,-29,198,-11,-18
3495,1,26,144,8,18
3496,1,-12,20,-10,-2
3497,1,-6,-7,1,-7
3498,1,2,-168,14,-12
3499,1,-3,-180,-15,12
3500,1,8,-153,-9,17
3501,1,-13,-48,-16,3
3502,1,-15,56,-7,-8
3503,1,-9,18,-3,-6
3504,1,4,-12,6,-2
3505,1,-7,-60,5,-12
3506,1,8,15,5,3
3507,1,22,96,6,16
3508,1,-18,72,-6,-12
3509,1,8,-20,-2,10
3510,1,-23,132,-12,-11
3511,1,26,144,8,18
3512,1,21,104,13,8
3513,1,0,-144,12,-12
3514,1,15,36,3,12
3515,1,23,126,9,14
3516,1,-21,54,-3,-18
3517,1,-9,-220,-20,11
3518,1,-15,-100,5,-20
3519,1,0,-324,18,-18
3520,1,17,0,17,0
3521,1,-39,380,-19,-20
3522,1,18,81,9,9
3523,1,12,0,12,0
3524,1,-2,-143,11,-13
3525,1,16,-17,17,-1
3526,1,12,-108,-6,18
3527,1,11,-80,-5,16
3528,1,26,144,18,8
3529,1,25,136,8,17
3530,1,11,0,11,0
3531,1,-2,-35,-7,5
3532,1,12,-45,15,-3
3533,1,-10,-75,-15,5
3534,1,1,-6,-2,3
3535,1,2,-3,-1,3
3536,1,7,-228,19,-12
3537,1,-4,-77,-11,7
3538,1,14,-120,20,-6
3539,1,-17,-18,-18,1
3540,1,5,-204,17,-12
3541,1,-13,-48,3,-16
3542,1,14,-51,17,-3
3543,1,-1,-342,-19,18
3544,1,-7,-78,6,-13
3545,1,-28,196,-14,-14
3546,1,-1,-306,17,-18
3547,1,-30,221,-17,-13
3548,1,-9,8,-8,-1
3549,1,-14,-15,1,-15
3550,1,5,-266,-14,19
3551,1,-28,160,-8,-20
3552,1,3,-108,-9,12
3553,1,21,68,17,4
3554,1,-21,54,-3,-18
3555,1,5,-36,9,-4
3556,1,-9,-70,-14,5
3557,1,9,-22,11,-2
3558,1,24,80,20,4
3559,1,-19,88,-8,-11
3560,1,23,60,20,3
3561,1,3,-108,12,-9
3562,1,-7,-60,5,-12
3563,1,30,225,15,15
3564,1,22,40,20,2
3565,1,-1,-90,-10,9
3566,1,0,-324,18,-18
3567,1,21,80,5,16
3568,1,-20,0,-20,0
3569,1,-22,40,-20,-2
3570,1,18,32,2,16
3571,1,-18,-40,2,-20
3572,1,-26,168,-12,-14
3573,1,10,-144,-8,18
3574,1,-17,30,-2,-15
3575,1,14,24,2,12
3576,1,-13,12,-12,-1
3577,1,7,-170,17,-10
3578,1,-6,-247,13,-19
3579,1,12,32,4,8
3580,1,14,48,8,6
3581,1,-20,75,-15,-5
3582,1,30,209,11,19
3583,1,10,-96,16,-6
3584,1,-6,-27,-9,3
3585,1,-37,342,-19,-18
3586,1,-23,76,-19,-4
3587,1,-1,-240,15,-16
3588,1,23,132,11,12
3589,1,1,-90,-9,10
3590,1,25,144,16,9
3591,1,1,0,0,1
3592,1,-17,70,-7,-10
3593,1,20,19,1,19
3594,1,26,144,8,18
3595,1,-20,100,-10,-10
3596,1,5,-84,-7,12
3597,1,11,10,1,10
3598,1,5,-176,16,-11
3599,1,15,-54,18,-3
3600,1,-4,-77,-11,7
3601,1,1,-132,12,-11
3602,1,28,195,15,13
3603,1,29,180,9,20
3604,1,-4,-21,3,-7
3605,1,14,-51,-3,17
3606,1,28,171,9,19
3607,1,-5,-234,-18,13
3608,1,22,96,6,16
3609,1,4,-96,12,-8
3610,1,6,-72,-6,12
3611,1,2,-48,-6,8
3612,1,18,77,7,11
3613,1,22,72,4,18
3614,1,-31,240,-15,-16
3615,1,-30,200,-10,-20
3616,1,-12,35,-5,-7
3617,1,5,-150,-10,15
3618,1,11,18,2,9
3619,1,-30,200,-20,-10
3620,1,19,34,17,2
3621,1,-9,8,-1,-8
3622,1,14,-32,16,-2
3623,1,8,15,5,3
3624,1,-13,36,-9,-4
3625,1,0,-64,8,-8
3626,1,4,0,0,4
3627,1,33,260,13,20
3628,1,10,-56,-4,14
3629,1,-20,96,-12,-8
3630,1,2,-323,19,-17
3631,1,-4,3,-3,-1
3632,1,-4,-5,1,-5
3633,1,3,-180,-12,15
3634,1,-6,-135,9,-15
3635,1,-5,-36,4,-9
3636,1,-9,-220,-20,11
3637,1,-23,126,-14,-9
3638,1,13,42,7,6
3639,1,-1,-56,7,-8
3640,1,-5,-36,4,-9
3641,1,-24,135,-15,-9
3642,1,25,126,18,7
3643,1,3,-238,17,-14
3644,1,-16,15,-1,-15
3645,1,-26,120,-6,-20
3646,1,-5,-266,14,-19
3647,1,33,272,16,17
3648,1,-27,176,-11,-16
3649,1,-11,0,-11,0
3650,1,9,-162,18,-9
3651,1,6,-135,-9,15
3652,1,23,132,11,12
3653,1,-20,19,-19,-1
3654,1,0,-400,-20,20
3655,1,-24,128,-8,-16
3656,1,35,300,15,20
3657,1,-14,49,-7,-7
3658,1,-16,39,-3,-13
3659,1,12,-64,16,-4
3660,1,19,84,12,7
3661,1,-17,66,-6,-11
3662,1,1,-90,10,-9
3663,1,0,-324,-18,18
3664,1,-4,3,-1,-3
3665,1,7,0,0,7
3666,1,2,-143,-11,13
3667,1,-32,247,-19,-13
3668,1,-16,0,-16,0
3669,1,7,-144,-9,16
3670,1,5,-266,-14,19
3671,1,14,13,1,13
3672,1,17,16,1,16
3673,1,0,-100,-10,10
3674,1,-2,-48,6,-8
3675,1,13,40,5,8
3676,1,-22,72,-18,-4
3677,1,-15,56,-7,-8
3678,1,15,-100,-5,20
3679,1,-15,36,-12,-3
3680,1,-11,-152,8,-19
3681,1,-11,-180,9,-20
3682,1,-24,140,-14,-10
3683,1,13,-140,20,-7
3684,1,-10,9,-9,-1
3685,1,20,99,11,9
3686,1,-6,5,-1,-5
3687,1,-8,-84,-14,6
3688,1,26,144,18,8
3689,1,3,-270,-15,18
3690,1,0,-9,3,-3
3691,1,-15,44,-11,-4
3692,1,8,-240,-12,20
3693,1,37,340,20,17
3694,1,-32,240,-12,-20
3695,1,-14,13,-1,-13
3696,1,17,16,16,1
3697,1,-25,150,-10,-15
3698,1,17,72,8,9
3699,1,13,-114,19,-6
3700,1,9,-190,-10,19
3701,1,15,26,2,13
3702,1,-19,18,-18,-1
3703,1,0,-289,17,-17
3704,1,29,208,16,13
3705,1,-25,144,-16,-9
3706,1,-4,-5,1,-5
3707,1,-35,304,-19,-16
3708,1,30,224,16,14
3709,1,23,60,3,20
3710,1,28,187,11,17
3711,1,-4,-32,4,-8
3712,1,13,-30,-2,15
3713,1,20,100,10,10
3714,1,11,-80,16,-5
3715,1,11,-180,20,-9
3716,1,9,-52,13,-4
3717,1,4,-45,9,-5
3718,1,6,-160,16,-10
3719,1,-16,-36,2,-18
3720,1,5,-126,14,-9
3721,1,-7,-44,-11,4
3722,1,-29,180,-20,-9
3723,1,22,72,18,4
3724,1,24,95,19,5
3725,1,1,-306,-17,18
3726,1,12,-160,-8,20
3727,1,-1,-12,3,-4
3728,1,-12,-45,3,-15
3729,1,1,-6,-2,3
3730,1,-7,-228,-19,12
3731,1,-15,36,-3,-12
3732,1,26,133,19,7
3733,1,19,48,16,3
3734,1,-19,0,-19,0
3735,1,-18,72,-12,-6
3736,1,17,-18,-1,18
3737,1,27,180,15,12
3738,1,1,-210,15,-14
3739,1,-16,39,-13,-3
3740,1,10,25,5,5
3741,1,-4,-45,5,-9
3742,1,22,117,9,13
3743,1,-26,144,-8,-18
3744,1,-4,-45,-9,5
3745,1,-6,-216,-18,12
3746,1,26,165,11,15
3747,1,13,-48,16,-3
3748,1,-23,120,-15,-8
3749,1,5,-84,12,-7
3750,1,9,18,6,3
3751,1,6,-135,15,-9
3752,1,14,24,2,12
3753,1,-8,-65,5,-13
3754,1,22,117,13,9
3755,1,-5,-126,9,-14
3756,1,4,-221,17,-13
3757,1,6,-187,17,-11
3758,1,1,-380,20,-19
3759,1,6,-187,17,-11
3760,1,-1,-380,-20,19
3761,1,-15,-34,-17,2
3762,1,7,-44,11,-4
3763,1,-20,99,-11,-9
3764,1,-3,-88,8,-11
3765,1,17,70,10,7
3766,1,-17,60,-5,-12
3767,1,-26,120,-6,-20
3768,1,3,-18,6,-3
3769,1,-1,-306,-18,17
3770,1,-27,152,-19,-8
3771,1,-7,-260,-20,13
3772,1,-4,-77,7,-11
3773,1,15,54,6,9
3774,1,-12,-85,-17,5
3775,1,13,-140,20,-7
3776,1,12,32,4,8
3777,1,-6,-7,1,-7
3778,1,-14,49,-7,-7
3779,1,-14,-15,1,-15
3780,1,-17,16,-16,-1
3781,1,-15,44,-11,-4
3782,1,9,8,1,8
3783,1,1,-12,-3,4
3784,1,1,-380,-19,20
3785,1,-5,-300,-20,15
3786,1,18,-19,19,-1
3787,1,6,-160,16,-10
3788,1,17,0,17,0
3789,1,-7,-18,-9,2
3790,1,-14,33,-11,-3
3791,1,-29,204,-12,-17
3792,1,-27,180,-12,-15
3793,1,5,-84,12,-7
3794,1,0,-169,13,-13
3795,1,-34,288,-16,-18
3796,1,-2,-80,8,-10
3797,1,3,-88,11,-8
3798,1,-5,4,-1,-4
3799,1,27,176,11,16
3800,1,-30,209,-19,-11
3801,1,-19,84,-7,-12
3802,1,13,0,0,13
3803,1,18,80,8,10
3804,1,-5,-50,5,-10
3805,1,2,-288,18,-16
3806,1,-16,-36,2,-18
3807,1,-11,18,-9,-2
3808,1,32,255,17,15
3809,1,22,120,10,12
3810,1,-21,110,-11,-10
3811,1,7,-44,-4,11
3812,1,-14,40,-4,-10
3813,1,8,-240,-12,20
3814,1,11,-60,-4,15
3815,1,-30,216,-18,-12
3816,1,-4,-32,4,-8
3817,1,-18,17,-17,-1
3818,1,-22,40,-20,-2
3819,1,-11,-180,9,-20
3820,1,-7,0,-7,0
3821,1,-28,192,-16,-12
3822,1,-25,154,-11,-14
3823,1,-6,-280,-20,14
3824,1,-8,15,-5,-3
3825,1,2,-120,12,-10
3826,1,7,-144,-9,16
3827,1,26,133,19,7
3828,1,-11,-180,9,-20
3829,1,-3,-238,14,-17
3830,1,-6,-135,-15,9
3831,1,7,0,7,0
3832,1,-13,0,0,-13
3833,1,-19,-20,-20,1
3834,1,-1,-380,-20,19
3835,1,32,256,16,16
3836,1,18,72,12,6
3837,1,-2,-323,17,-19
3838,1,12,20,2,10
3839,1,-18,56,-14,-4
3840,1,-14,13,-1,-13
3841,1,10,-144,-8,18
3842,1,2,0,2,0
3843,1,-4,0,-4,0
3844,1,-6,-55,-11,5
3845,1,-2,-3,1,-3
3846,1,23,60,3,20
3847,1,6,9,3,3
3848,1,10,-96,16,-6
3849,1,15,50,5,10
3850,1,-5,-126,9,-14
3851,1,5,-14,7,-2
3852,1,-1,-20,-5,4
3853,1,-6,5,-1,-5
3854,1,-7,-18,-9,2
3855,1,-1,-156,-13,12
3856,1,26,133,7,19
3857,1,15,-34,-2,17
3858,1,8,-9,9,-1
3859,1,-7,6,-6,-1
3860,1,-5,6,-3,-2
3861,1,4,-285,19,-15
3862,1,2,-120,12,-10
3863,1,16,55,11,5
3864,1,-13,36,-9,-4
3865,1,-20,75,-15,-5
3866,1,20,51,17,3
3867,1,-13,12,-1,-12
3868,1,-1,-272,16,-17
3869,1,12,-160,-8,20
3870,1,-9,-162,-18,9
3871,1,-17,16,-1,-16
3872,1,11,-26,-2,13
3873,1,8,15,5,3
3874,1,11,30,6,5
3875,1,0,-256,-16,16
3876,1,-6,0,-6,0
3877,1,-34,280,-14,-20
3878,1,-6,-135,9,-15
3879,1,-21,54,-18,-3
3880,1,-11,0,0,-11
3881,1,15,54,9,6
3882,1,-28,192,-16,-12
3883,1,13,-114,-6,19
3884,1,10,-56,14,-4
3885,1,29,208,13,16
3886,1,-7,10,-5,-2
3887,1,-14,40,-4,-10
3888,1,-14,45,-5,-9
3889,1,6,5,1,5
3890,1,3,-180,-12,15
3891,1,-8,-153,-17,9
3892,1,-29,190,-19,-10
3893,1,-18,72,-6,-12
3894,1,-2,-224,-16,14
3895,1,-16,60,-6,-10
3896,1,15,50,10,5
3897,1,22,57,3,19
3898,1,18,72,12,6
3899,1,-9,-162,-18,9
3900,1,-26,133,-7,-19
3901,1,4,-192,-12,16
3902,1,9,18,3,6
3903,1,13,-140,-7,20
3904,1,-23,132,-12,-11
3905,1,6,-7,7,-1
3906,1,-24,135,-15,-9
3907,1,18,32,2,16
3908,1,-6,8,-4,-2
3909,1,18,-40,-2,20
3910,1,-10,0,0,-10
3911,1,-11,24,-8,-3
3912,1,-8,15,-5,-3
3913,1,-25,126,-18,-7
3914,1,11,-180,-9,20
3915,1,-9,-90,6,-15
3916,1,-10,24,-4,-6
3917,1,27,170,17,10
3918,1,-20,19,-1,-19
3919,1,-19,88,-11,-8
3920,1,5,-6,-1,6
3921,1,-36,320,-20,-16
3922,1,-13,12,-12,-1
3923,1,-1,-110,10,-11
3924,1,21,110,11,10
3925,1,-12,0,0,-12
3926,1,1,-72,9,-8
3927,1,-10,-24,2,-12
3928,1,21,20,1,20
3929,1,6,-247,19,-13
3930,1,-4,-12,-6,2
3931,1,7,6,1,6
3932,1,-13,-14,-14,1
3933,1,25,136,8,17
3934,1,13,40,5,8
3935,1,-28,171,-9,-19
3936,1,20,0,20,0
3937,1,-10,-96,-16,6
3938,1,34,289,17,17
3939,1,-8,-128,8,-16
3940,1,-16,48,-12,-4
3941,1,27,152,19,8
3942,1,-13,36,-9,-4
3943,1,0,-256,-16,16
3944,1,18,56,4,14
3945,1,9,-52,13,-4
3946,1,11,-42,14,-3
3947,1,-12,-28,2,-14
3948,1,26,133,19,7
3949,1,5,-24,-3,8
3950,1,23,120,8,15
3951,1,-21,38,-19,-2
3952,1,-16,55,-5,-11
3953,1,20,84,14,6
3954,1,13,-14,-1,14
3955,1,-15,56,-8,-7
3956,1,4,3,1,3
3957,1,-9,-112,-16,7
3958,1,-10,-75,5,-15
3959,1,-1,-6,-3,2
3960,1,37,340,20,17
3961,1,-18,80,-10,-8
3962,1,-3,-108,9,-12
3963,1,-7,-170,10,-17
3964,1,-29,204,-12,-17
3965,1,9,-70,-5,14
3966,1,-25,144,-16,-9
3967,1,28,160,20,8
3968,1,29,210,15,14
3969,1,12,-45,-3,15
3970,1,8,-84,-6,14
3971,1,-5,-36,-9,4
3972,1,-18,77,-7,-11
3973,1,1,-30,6,-5
3974,1,2,-323,-17,19
3975,1,4,-12,-2,6
3976,1,-19,48,-3,-16
3977,1,0,-64,-8,8
3978,1,-6,-40,-10,4
3979,1,14,-15,-1,15
3980,1,22,40,2,20
3981,1,3,-154,14,-11
3982,1,5,-14,7,-2
3983,1,-23,90,-5,-18
3984,1,-14,40,-10,-4
3985,1,-31,220,-20,-11
3986,1,-22,105,-7,-15
3987,1,-7,-44,4,-11
3988,1,4,-285,19,-15
3989,1,22,105,7,15
3990,1,-11,-42,3,-14
3991,1,-11,-102,-17,6
3992,1,-20,19,-19,-1
3993,1,0,-256,16,-16
3994,1,-37,342,-19,-18
3995,1,30,209,19,11
3996,1,18,81,9,9
3997,1,-3,-130,10,-13
3998,1,3,-238,-14,17
3999,1,4,-21,7,-3
4000,1,17,66,6,11
4001,1,-7,0,-7,0
4002,1,11,30,6,5
4003,1,-6,-187,-17,11
4004,1,-1,-6,-3,2
4005,1,2,-288,18,-16
4006,1,0,-196,14,-14
4007,1,36,323,19,17
4008,1,-18,72,-12,-6
4009,1,1,-30,-5,6
4010,1,-17,52,-4,-13
4011,1,-22,85,-17,-5
4012,1,9,-90,-6,15
4013,1,20,91,7,13
4014,1,-13,12,-1,-12
4015,1,-2,-255,-17,15
4016,1,-32,240,-20,-12
4017,1,-11,18,-9,-2
4018,1,14,45,5,9
4019,1,-12,32,-8,-4
4020,1,-10,9,-1,-9
4021,1,-28,192,-16,-12
4022,1,-14,13,-1,-13
4023,1,11,-12,-1,12
4024,1,11,-126,-7,18
4025,1,26,153,9,17
4026,1,-16,-57,-19,3
4027,1,-9,-220,-20,11
4028,1,4,4,2,2
4029,1,13,-14,-1,14
4030,1,11,24,8,3
4031,1,-6,-247,13,-19
4032,1,18,0,18,0
4033,1,25,100,20,5
4034,1,0,-36,-6,6
4035,1,1,-342,-18,19
4036,1,13,-14,-1,14
4037,1,2,-288,-16,18
4038,1,14,49,7,7
4039,1,-28,195,-13,-15
4040,1,-28,171,-19,-9
4041,1,-3,-28,-7,4
4042,1,-12,-160,8,-20
4043,1,23,132,11,12
4044,1,-8,-105,7,-15
4045,1,1,-132,-11,12
4046,1,10,-56,-4,14
4047,1,32,256,16,16
4048,1,-22,40,-2,-20
4049,1,-4,-320,-20,16
4050,1,-21,108,-12,-9
4051,1,-17,16,-16,-1
4052,1,12,-108,18,-6
4053,1,3,-18,-3,6
4054,1,-2,-195,-15,13
4055,1,1,-272,-16,17
4056,1,9,0,0,9
4057,1,-21,80,-16,-5
4058,1,-25,100,-5,-20
4059,1,12,-85,17,-5
4060,1,-5,4,-4,-1
4061,1,30,200,20,10
4062,1,-11,30,-5,-6
4063,1,4,-77,-7,11
4064,1,-11,0,0,-11
4065,1,21,98,14,7
4066,1,-20,51,-17,-3
4067,1,4,-320,20,-16
4068,1,25,114,19,6
4069,1,-2,-288,-18,16
4070,1,19,48,3,16
4071,1,3,-154,14,-11
4072,1,15,-100,-5,20
4073,1,20,91,13,7
4074,1,38,360,18,20
4075,1,-7,10,-2,-5
4076,1,-13,-90,5,-18
4077,1,-14,-120,6,-20
4078,1,12,-28,14,-2
4079,1,4,-96,-8,12
4080,1,-4,-96,8,-12
4081,1,-6,-27,-9,3
4082,1,-6,-112,8,-14
4083,1,-16,-36,2,-18
4084,1,20,91,13,7
4085,1,32,240,20,12
4086,1,7,-18,9,-2
4087,1,-28,171,-19,-9
4088,1,15,-100,20,-5
4089,1,3,-40,-5,8
4090,1,-18,65,-5,-13
4091,1,5,-50,-5,10
4092,1,-11,10,-1,-10
4093,1,1,-90,10,-9
4094,1,-3,2,-1,-2
4095,1,-30,209,-19,-11
4096,1,7,-120,-8,15
4097,1,-4,-12,-6,2
4098,1,9,-90,15,-6
4099,1,14,40,10,4
4100,1,15,56,7,8
4101,1,9,-70,14,-5
4102,1,5,-266,-14,19
4103,1,-14,33,-11,-3
4104,1,-1,-6,-3,2
4105,1,-24,143,-13,-11
4106,1,-11,-152,8,-19
4107,1,-24,95,-19,-5
4108,1,-32,252,-14,-18
4109,1,-21,38,-19,-2
4110,1,3,-54,-6,9
4111,1,-28,187,-11,-17
4112,1,-27,182,-14,-13
4113,1,-9,-36,3,-12
4114,1,21,68,17,4
4115,1,12,0,0,12
4116,1,-15,-54,-18,3
4117,1,-11,-152,-19,8
4118,1,-23,60,-3,-20
4119,1,0,-256,-16,16
4120,1,5,-24,8,-3
4121,1,10,25,5,5
4122,1,-16,15,-15,-1
4123,1,-16,-17,1,-17
4124,1,-23,90,-5,-18
4125,1,-1,-156,12,-13
4126,1,6,-27,9,-3
4127,1,-18,0,0,-18
4128,1,1,-272,-16,17
4129,1,3,-180,15,-12
4130,1,8,-48,-4,12
4131,1,-1,0,0,-1
4132,1,11,-60,15,-4
4133,1,31,228,12,19
4134,1,-29,198,-11,-18
4135,1,13,-140,20,-7
4136,1,4,4,2,2
4137,1,4,-221,-13,17
4138,1,5,-36,-4,9
4139,1,-12,-160,8,-20
4140,1,4,-252,18,-14
4141,1,-3,-4,1,-4
4142,1,19,0,0,19
4143,1,11,28,7,4
4144,1,19,70,14,5
4145,1,25,156,12,13
4146,1,-40,400,-20,-20
4147,1,-6,9,-3,-3
4148,1,-19,70,-5,-14
4149,1,8,-240,-12,20
4150,1,-7,-44,-11,4
4151,1,1,-182,-13,14
4152,1,20,96,12,8
4153,1,5,-176,16,-11
4154,1,4,0,4,0
4155,1,-17,0,-17,0
4156,1,10,-56,14,-4
4157,1,12,-28,14,-2
4158,1,-4,-96,8,-12
4159,1,-30,200,-10,-20
4160,1,9,20,5,4
4161,1,-11,24,-3,-8
4162,1,-28,192,-16,-12
4163,1,-3,-88,8,-11
4164,1,-13,-30,-15,2
4165,1,-11,18,-2,-9
4166,1,15,36,12,3
4167,1,-15,-100,5,-20
4168,1,10,21,3,7
4169,1,20,0,20,0
4170,1,3,-304,19,-16
4171,1,-32,240,-20,-12
4172,1,-1,-42,-7,6
4173,1,37,340,20,17
4174,1,-3,0,-3,0
4175,1,29,190,19,10
4176,1,-25,150,-10,-15
4177,1,-2,-63,7,-9
4178,1,-26,168,-12,-14
4179,1,-14,-51,-17,3
4180,1,19,60,15,4
4181,1,-29,210,-14,-15
4182,1,38,360,20,18
4183,1,-6,-40,4,-10
4184,1,3,-130,13,-10
4185,1,6,-280,-14,20
4186,1,26,160,10,16
4187,1,-25,156,-12,-13
4188,1,26,168,12,14
4189,1,2,-48,8,-6
4190,1,27,140,7,20
4191,1,6,-72,12,-6
4192,1,-27,176,-11,-16
4193,1,-7,10,-5,-2
4194,1,17,60,5,12
4195,1,20,19,1,19
4196,1,16,39,13,3
4197,1,-4,-60,6,-10
4198,1,-2,-8,2,-4
4199,1,-4,4,-2,-2
4200,1,13,-48,16,-3
4201,1,-6,-112,8,-14
4202,1,-12,-13,-13,1
4203,1,-13,-68,4,-17
4204,1,13,36,9,4
4205,1,5,-104,-8,13
4206,1,-17,16,-1,-16
4207,1,-1,-132,11,-12
4208,1,17,30,15,2
4209,1,1,-110,-10,11
4210,1,-20,51,-17,-3
4211,1,16,-80,20,-4
4212,1,6,-91,13,-7
4213,1,16,-57,19,-3
4214,1,-18,72,-6,-12
4215,1,-16,48,-4,-12
4216,1,-18,17,-1,-17
4217,1,3,-70,-7,10
4218,1,10,-75,15,-5
4219,1,6,5,1,5
4220,1,-24,135,-15,-9
4221,1,-15,56,-8,-7
4222,1,-10,-96,-16,6
4223,1,14,48,6,8
4224,1,12,-133,19,-7
4225,1,15,14,14,1
4226,1,-15,56,-7,-8
4227,1,-9,-162,-18,9
4228,1,18,17,17,1
4229,1,-3,-130,-13,10
4230,1,-16,0,0,-16
4231,1,-9,-220,-20,11
4232,1,26,153,17,9
4233,1,-8,16,-4,-4
4234,1,-14,40,-10,-4
4235,1,12,20,10,2
4236,1,17,-18,-1,18
4237,1,-7,10,-5,-2
4238,1,15,56,8,7
4239,1,16,0,16,0
4240,1,-15,44,-11,-4
4241,1,-27,182,-13,-14
4242,1,-14,49,-7,-7
4243,1,22,120,10,12
4244,1,-1,-20,4,-5
4245,1,-26,165,-11,-15
4246,1,-1,-56,-8,7
4247,1,1,-72,-8,9
4248,1,20,84,6,14
4249,1,1,-30,6,-5
4250,1,6,-160,-10,16
4251,1,-19,-20,1,-20
4252,1,22,105,7,15
4253,1,-3,-180,-15,12
4254,1,-29,204,-17,-12
4255,1,27,152,8,19
4256,1,13,-90,-5,18
4257,1,-4,-252,-18,14
4258,1,7,-30,10,-3
4259,1,-28,171,-19,-9
4260,1,11,28,7,4
4261,1,-3,-70,7,-10
4262,1,29,198,11,18
4263,1,20,51,3,17
4264,1,3,-10,5,-2
4265,1,10,-11,11,-1
4266,1,-4,-5,1,-5
4267,1,16,-80,20,-4
4268,1,-3,-40,5,-8
4269,1,-34,280,-14,-20
4270,1,12,-45,15,-3
4271,1,12,-85,17,-5
4272,1,-4,-60,-10,6
4273,1,-24,119,-7,-17
4274,1,20,91,7,13
4275,1,9,18,6,3
4276,1,12,-13,-1,13
4277,1,11,0,0,11
4278,1,-6,-216,-18,12
4279,1,20,0,0,20
4280,1,4,-192,-12,16
4281,1,28,160,8,20
4282,1,-8,0,-8,0
4283,1,-29,210,-14,-15
4284,1,31,240,15,16
4285,1,6,8,4,2
4286,1,32,256,16,16
4287,1,30,209,11,19
4288,1,-34,288,-16,-18
4289,1,19,0,19,0
4290,1,19,48,3,16
4291,1,-4,-117,-13,9
4292,1,5,-24,-3,8
4293,1,-29,210,-14,-15
4294,1,-18,65,-5,-13
4295,1,-1,-42,-7,6
4296,1,15,-76,-4,19
4297,1,16,64,8,8
4298,1,-6,-247,-19,13
4299,1,-6,-216,-18,12
4300,1,-11,-180,-20,9
4301,1,28,195,15,13
4302,1,0,-169,13,-13
4303,1,-9,20,-4,-5
4304,1,21,108,12,9
4305,1,-27,162,-9,-18
4306,1,-13,-14,1,-14
4307,1,-11,10,-10,-1
4308,1,18,0,0,18
4309,1,4,-221,-13,17
4310,1,34,280,20,14
4311,1,0,0,0,0
4312,1,-13,-90,-18,5
4313,1,-2,1,-1,-1
4314,1,14,-72,18,-4
4315,1,-10,-144,-18,8
4316,1,-1,-110,10,-11
4317,1,22,85,5,17
4318,1,-14,33,-3,-11
4319,1,-15,56,-7,-8
4320,1,9,-136,-8,17
4321,1,-8,-153,9,-17
4322,1,-17,0,0,-17
4323,1,23,130,10,13
4324,1,-10,-39,-13,3
4325,1,0,-81,-9,9
4326,1,-8,-128,8,-16
4327,1,24,135,9,15
4328,1,7,-144,16,-9
4329,1,13,-140,-7,20
4330,1,-5,-176,11,-16
4331,1,30,221,17,13
4332,1,-29,204,-17,-12
4333,1,-2,-35,-7,5
4334,1,-6,-27,3,-9
4335,1,9,8,1,8
4336,1,3,0,0,3
4337,1,2,-143,-11,13
4338,1,14,-15,15,-1
4339,1,-6,-7,-7,1
4340,1,14,33,11,3
4341,1,-5,-14,2,-7
4342,1,-4,-5,-5,1
4343,1,4,-252,-14,18
4344,1,-1,-182,13,-14
4345,1,-9,-190,10,-19
4346,1,30,221,17,13
4347,1,12,32,8,4
4348,1,-11,0,0,-11
4349,1,-26,165,-11,-15
4350,1,16,-57,-3,19
4351,1,-11,24,-8,-3
4352,1,4,-96,12,-8
4353,1,-10,24,-4,-6
4354,1,17,60,12,5
4355,1,1,-20,-4,5
4356,1,24,140,14,10
4357,1,-23,60,-3,-20
4358,1,39,380,19,20
4359,1,0,-400,20,-20
4360,1,-14,48,-6,-8
4361,1,-19,90,-10,-9
4362,1,11,-12,12,-1
4363,1,-16,63,-7,-9
4364,1,19,0,0,19
4365,1,29,180,20,9
4366,1,16,39,13,3
4367,1,-18,56,-4,-14
4368,1,21,38,2,19
4369,1,20,36,2,18
4370,1,-27,180,-15,-12
4371,1,19,18,1,18
4372,1,-4,-221,-17,13
4373,1,5,0,0,5
4374,1,3,-238,-14,17
4375,1,-7,10,-5,-2
4376,1,-12,0,-12,0
4377,1,15,50,5,10
4378,1,6,-16,-2,8
4379,1,-22,96,-6,-16
4380,1,7,12,3,4
4381,1,21,110,10,11
4382,1,-3,-88,8,-11
4383,1,16,0,16,0
4384,1,-14,40,-4,-10
4385,1,33,272,17,16
4386,1,0,-324,-18,18
4387,1,22,57,19,3
4388,1,-8,-20,-10,2
4389,1,-17,0,0,-17
4390,1,-16,-57,-19,3
4391,1,25,136,17,8
4392,1,-7,12,-4,-3
4393,1,17,42,3,14
4394,1,-31,238,-14,-17
4395,1,-10,16,-2,-8
4396,1,23,102,6,17
4397,1,-12,-13,1,-13
4398,1,9,-220,20,-11
4399,1,-11,24,-3,-8
4400,1,7,-228,-12,19
4401,1,0,-36,6,-6
4402,1,0,-9,3,-3
4403,1,10,-75,-5,15
4404,1,16,28,14,2
4405,1,2,-120,-10,12
4406,1,35,304,19,16
4407,1,2,-24,-4,6
4408,1,-29,198,-18,-11
4409,1,-8,-240,-20,12
4410,1,-2,-195,-15,13
4411,1,22,117,9,13
4412,1,15,-54,-3,18
4413,1,-9,-112,7,-16
4414,1,-34,288,-18,-16
4415,1,33,272,16,17
4416,1,6,-112,14,-8
4417,1,-3,2,-2,-1
4418,1,12,35,5,7
4419,1,17,16,16,1
4420,1,1,-210,-14,15
4421,1,9,-10,10,-1
4422,1,24,128,16,8
4423,1,9,-190,-10,19
4424,1,21,20,1,20
4425,1,-4,-77,7,-11
4426,1,3,-304,19,-16
4427,1,3,-340,-17,20
4428,1,13,42,7,6
4429,1,-18,45,-15,-3
4430,1,11,-102,-6,17
4431,1,-23,112,-16,-7
4432,1,-9,-22,2,-11
4433,1,7,-44,-4,11
4434,1,9,20,4,5
4435,1,18,77,11,7
4436,1,-11,-12,1,-12
4437,1,22,120,12,10
4438,1,20,19,19,1
4439,1,17,60,5,12
4440,1,6,-55,11,-5
4441,1,20,91,13,7
4442,1,-6,-135,-15,9
4443,1,-8,0,-8,0
4444,1,-24,140,-14,-10
4445,1,20,19,1,19
4446,1,-12,-64,-16,4
4447,1,0,-121,-11,11
4448,1,17,52,13,4
4449,1,8,-65,13,-5
4450,1,-30,221,-17,-13
4451,1,19,78,6,13
4452,1,19,34,17,2
4453,1,-4,-45,5,-9
4454,1,-1,-110,10,-11
4455,1,-26,120,-6,-20
4456,1,16,48,4,12
4457,1,0,-25,-5,5
4458,1,-17,-18,1,-18
4459,1,-15,-100,5,-20
4460,1,-20,36,-18,-2
4461,1,22,85,5,17
4462,1,-4,4,-2,-2
4463,1,-5,-234,13,-18
4464,1,-19,34,-17,-2
4465,1,-1,-20,-5,4
4466,1,0,-36,6,-6
4467,1,-19,78,-13,-6
4468,1,-2,-8,-4,2
4469,1,5,0,5,0
4470,1,-1,-156,12,-13
4471,1,-11,-126,-18,7
4472,1,-2,-80,8,-10
4473,1,18,45,15,3
4474,1,22,57,19,3
4475,1,-14,-15,-15,1
4476,1,5,-126,-9,14
4477,1,18,80,8,10
4478,1,7,-44,-4,11
4479,1,10,-119,17,-7
4480,1,-1,-182,13,-14
4481,1,-4,-192,-16,12
4482,1,0,0,0,0
4483,1,2,-168,-12,14
4484,1,-3,0,-3,0
4485,1,-20,64,-4,-16
4486,1,-11,-180,-20,9
4487,1,11,-60,-4,15
4488,1,3,-54,-6,9
4489,1,13,-14,14,-1
4490,1,4,-45,9,-5
4491,1,26,133,19,7
4492,1,-20,84,-6,-14
4493,1,19,18,18,1
4494,1,-33,260,-13,-20
4495,1,5,-126,-9,14
4496,1,22,121,11,11
4497,1,-7,-78,-13,6
4498,1,-6,8,-4,-2
4499,1,0,-289,-17,17
4500,1,-14,-32,-16,2
4501,1,8,15,3,5
4502,1,0,-100,10,-10
4503,1,-7,12,-4,-3
4504,1,7,-60,12,-5
4505,1,17,16,1,16
4506,1,-17,16,-16,-1
4507,1,-7,-30,-10,3
4508,1,9,-90,15,-6
4509,1,-38,361,-19,-19
4510,1,-19,48,-16,-3
4511,1,19,60,4,15
4512,1,18,77,11,7
4513,1,-24,144,-12,-12
4514,1,21,38,19,2
4515,1,-7,12,-3,-4
4516,1,-2,-15,3,-5
4517,1,-5,-150,10,-15
4518,1,-4,-21,3,-7
4519,1,9,-112,-7,16
4520,1,-8,-65,5,-13
4521,1,-12,27,-9,-3
4522,1,-9,-10,1,-10
4523,1,-12,-160,8,-20
4524,1,-1,-42,6,-7
4525,1,14,-95,-5,19
4526,1,11,24,3,8
4527,1,-15,44,-11,-4
4528,1,8,-153,-9,17
4529,1,0,-81,-9,9
4530,1,4,-165,-11,15
4531,1,25,136,8,17
4532,1,24,80,20,4
4533,1,-18,45,-3,-15
4534,1,36,320,20,16
4535,1,2,-168,-12,14
4536,1,12,-108,18,-6
4537,1,-15,54,-6,-9
4538,1,18,-40,20,-2
4539,1,-15,14,-1,-14
4540,1,-12,35,-5,-7
4541,1,-4,-140,-14,10
4542,1,15,54,6,9
4543,1,-12,11,-11,-1
4544,1,18,45,15,3
4545,1,-16,39,-3,-13
4546,1,16,0,0,16
4547,1,-6,-135,9,-15
4548,1,8,-105,15,-7
4549,1,-6,5,-5,-1
4550,1,-31,220,-20,-11
4551,1,-21,110,-11,-10
4552,1,10,21,7,3
4553,1,7,-260,-13,20
4554,1,21,54,18,3
4555,1,26,120,6,20
4556,1,2,-143,13,-11
4557,1,-15,56,-8,-7
4558,1,21,68,17,4
4559,1,6,-55,-5,11
4560,1,-24,135,-15,-9
4561,1,11,-26,-2,13
4562,1,1,-6,3,-2
4563,1,-5,-14,2,-7
4564,1,0,-400,20,-20
4565,1,20,96,12,8
4566,1,-15,-34,2,-17
4567,1,15,-76,19,-4
4568,1,-7,-60,-12,5
4569,1,12,36,6,6
4570,1,-17,-18,1,-18
4571,1,5,-14,-2,7
4572,1,-6,-55,5,-11
4573,1,8,-128,-8,16
4574,1,26,120,6,20
4575,1,-14,-15,-15,1
4576,1,27,170,10,17
4577,1,18,56,4,14
4578,1,-10,-171,9,-19
4579,1,27,140,7,20
4580,1,16,39,13,3
4581,1,-3,-270,-18,15
4582,1,4,-77,-7,11
4583,1,-4,0,0,-4
4584,1,-10,0,0,-10
4585,1,-10,21,-7,-3
4586,1,-26,153,-17,-9
4587,1,-3,-304,16,-19
4588,1,-9,14,-2,-7
4589,1,-27,162,-18,-9
4590,1,23,130,10,13
4591,1,-36,320,-20,-16
4592,1,1,-6,-2,3
4593,1,13,22,11,2
4594,1,-39,380,-19,-20
4595,1,-37,340,-17,-20
4596,1,-5,6,-2,-3
4597,1,21,80,5,16
4598,1,21,54,18,3
4599,1,-37,340,-17,-20
4600,1,-31,220,-11,-20
4601,1,11,24,3,8
4602,1,22,85,5,17
4603,1,24,119,7,17
4604,1,-10,-56,4,-14
4605,1,-5,-150,10,-15
4606,1,8,7,1,7
4607,1,22,121,11,11
4608,1,-12,-64,4,-16
4609,1,-1,0,-1,0
4610,1,-10,-24,2,-12
4611,1,-22,120,-10,-12
4612,1,22,96,6,16
4613,1,12,-45,-3,15
4614,1,-5,-14,2,-7
4615,1,13,-90,18,-5
4616,1,-8,16,-4,-4
4617,1,-39,380,-20,-19
4618,1,11,-26,13,-2
4619,1,-9,8,-8,-1
4620,1,8,-84,-6,14
4621,1,-17,66,-11,-6
4622,1,3,-208,16,-13
4623,1,18,32,2,16
4624,1,-31,240,-16,-15
4625,1,10,-56,-4,14
4626,1,31,238,14,17
4627,1,23,112,16,7
4628,1,22,72,18,4
4629,1,22,105,15,7
4630,1,30,221,17,13
4631,1,3,-54,-6,9
4632,1,30,221,17,13
4633,1,6,-187,-11,17
4634,1,-2,-80,-10,8
4635,1,4,-21,-3,7
4636,1,16,39,3,13
4637,1,-19,88,-11,-8
4638,1,9,-10,10,-1
4639,1,7,-260,-13,20
4640,1,-3,-304,16,-19
4641,1,12,11,11,1
4642,1,5,-24,-3,8
4643,1,16,55,11,5
4644,1,16,15,15,1
4645,1,-22,121,-11,-11
4646,1,1,-56,-7,8
4647,1,2,-224,-14,16
4648,1,6,-160,-10,16
4649,1,-4,-285,15,-19
4650,1,-5,-266,14,-19
4651,1,-20,96,-12,-8
4652,1,20,91,7,13
4653,1,-13,-68,-17,4
4654,1,-21,80,-5,-16
4655,1,30,209,19,11
4656,1,3,-28,7,-4
4657,1,-4,-60,6,-10
4658,1,-7,12,-4,-3
4659,1,24,80,20,4
4660,1,3,-108,-9,12
4661,1,3,-18,6,-3
4662,1,-28,160,-8,-20
4663,1,-13,-48,3,-16
4664,1,3,-130,-10,13
4665,1,-30,209,-11,-19
4666,1,12,20,2,10
4667,1,15,56,7,8
4668,1,-4,3,-1,-3
4669,1,19,70,14,5
4670,1,3,-108,-9,12
4671,1,-2,-255,-17,15
4672,1,25,100,20,5
4673,1,-28,171,-19,-9
4674,1,-29,180,-20,-9
4675,1,10,-11,11,-1
4676,1,-11,-152,-19,8
4677,1,1,-380,-19,20
4678,1,8,0,0,8
4679,1,-8,-180,10,-18
4680,1,-12,35,-5,-7
4681,1,-15,50,-5,-10
4682,1,29,180,20,9
4683,1,-9,-220,11,-20
4684,1,35,306,17,18
4685,1,2,-224,16,-14
4686,1,8,-33,-3,11
4687,1,29,180,20,9
4688,1,-10,25,-5,-5
4689,1,31,238,14,17
4690,1,6,-91,13,-7
4691,1,-21,108,-9,-12
4692,1,-29,208,-13,-16
4693,1,1,-342,-18,19
4694,1,-16,0,-16,0
4695,1,0,-144,-12,12
4696,1,-28,187,-17,-11
4697,1,14,-72,-4,18
4698,1,0,-81,-9,9
4699,1,-22,105,-7,-15
4700,1,-8,15,-3,-5
4701,1,24,80,4,20
4702,1,-33,266,-14,-19
4703,1,11,-12,-1,12
4704,1,13,-48,-3,16
4705,1,-11,18,-9,-2
4706,1,13,42,7,6
4707,1,-6,-91,7,-13
4708,1,23,90,18,5
4709,1,23,76,4,19
4710,1,24,140,14,10
4711,1,9,-52,13,-4
4712,1,5,-66,-6,11
4713,1,-10,9,-1,-9
4714,1,6,-27,9,-3
4715,1,4,-32,-4,8
4716,1,-23,130,-10,-13
4717,1,-10,-24,-12,2
4718,1,-27,170,-10,-17
4719,1,-19,48,-3,-16
4720,1,-18,17,-17,-1
4721,1,-21,80,-16,-5
4722,1,8,-20,10,-2
4723,1,-4,-5,-5,1
4724,1,-14,24,-12,-2
4725,1,27,180,12,15
4726,1,-24,108,-6,-18
4727,1,-37,342,-18,-19
4728,1,-9,-112,-16,7
4729,1,-11,-42,3,-14
4730,1,-22,120,-12,-10
4731,1,2,-15,-3,5
4732,1,1,-132,-11,12
4733,1,8,-20,10,-2
4734,1,19,70,14,5
4735,1,11,-42,-3,14
4736,1,-17,66,-6,-11
4737,1,0,-121,-11,11
4738,1,2,-80,10,-8
4739,1,7,-170,-10,17
4740,1,-35,300,-15,-20
4741,1,-8,-153,-17,9
4742,1,25,136,8,17
4743,1,23,112,16,7
4744,1,10,16,8,2
4745,1,16,-57,-3,19
4746,1,22,57,3,19
4747,1,25,100,5,20
4748,1,30,209,11,19
4749,1,9,-220,20,-11
4750,1,5,-84,12,-7
4751,1,1,-30,6,-5
4752,1,13,12,12,1
4753,1,34,285,19,15
4754,1,-9,-162,9,-18
4755,1,-12,-13,1,-13
4756,1,10,-200,-10,20
4757,1,13,-30,15,-2
4758,1,12,-85,17,-5
4759,1,-16,-36,2,-18
4760,1,9,-90,15,-6
4761,1,-20,100,-10,-10
4762,1,1,-182,-13,14
4763,1,-11,-42,3,-14
4764,1,-28,195,-15,-13
4765,1,20,99,9,11
4766,1,34,288,16,18
4767,1,-27,176,-11,-16
4768,1,15,44,11,4
4769,1,-21,68,-4,-17
4770,1,-11,-12,1,-12
4771,1,5,-24,8,-3
4772,1,-8,-209,-19,11
4773,1,1,-30,-5,6
4774,1,-24,135,-9,-15
4775,1,-27,152,-8,-19
4776,1,-9,-70,-14,5
4777,1,1,0,1,0
4778,1,3,-340,20,-17
4779,1,-29,210,-15,-14
4780,1,-23,76,-19,-4
4781,1,26,120,20,6
4782,1,-15,50,-10,-5
4783,1,25,154,11,14
4784,1,-20,99,-9,-11
4785,1,19,34,17,2
4786,1,31,228,19,12
4787,1,9,-36,12,-3
4788,1,32,255,15,17
4789,1,1,-42,-6,7
4790,1,-22,40,-2,-20
4791,1,-29,198,-11,-18
4792,1,0,-100,-10,10
4793,1,14,24,12,2
4794,1,-31,238,-17,-14
4795,1,38,361,19,19
4796,1,10,24,6,4
4797,1,-14,-32,-16,2
4798,1,-25,154,-11,-14
4799,1,39,380,20,19
4800,1,6,-91,13,-7
4801,1,2,-15,5,-3
4802,1,14,40,4,10
4803,1,-39,380,-19,-20
4804,1,-14,-15,-15,1
4805,1,-15,54,-6,-9
4806,1,-11,18,-9,-2
4807,1,1,0,1,0
4808,1,10,24,6,4
4809,1,-2,-48,-8,6
4810,1,-6,0,-6,0
4811,1,4,-252,18,-14
4812,1,8,15,3,5
4813,1,15,14,1,14
4814,1,18,56,14,4
4815,1,-13,-90,-18,5
4816,1,-30,209,-19,-11
4817,1,23,126,9,14
4818,1,-14,40,-4,-10
4819,1,-39,380,-19,-20
4820,1,-3,-54,6,-9
4821,1,13,0,13,0
4822,1,-30,225,-15,-15
4823,1,-10,24,-6,-4
4824,1,-5,-104,-13,8
4825,1,-10,-24,-12,2
4826,1,-4,3,-1,-3
4827,1,-18,-19,1,-19
4828,1,-17,0,0,-17
4829,1,-33,270,-18,-15
4830,1,-4,3,-3,-1
4831,1,-11,28,-4,-7
4832,1,-7,-44,4,-11
4833,1,3,-10,5,-2
4834,1,27,180,15,12
4835,1,-3,-270,-18,15
4836,1,2,-323,19,-17
4837,1,-3,-28,-7,4
4838,1,27,140,20,7
4839,1,-19,18,-1,-18
4840,1,-7,10,-5,-2
4841,1,32,247,13,19
4842,1,2,-80,-8,10
4843,1,-13,22,-2,-11
4844,1,-18,0,0,-18
4845,1,-3,-70,-10,7
4846,1,23,130,10,13
4847,1,11,18,9,2
4848,1,-1,-182,13,-14
4849,1,11,-26,-2,13
4850,1,-30,200,-20,-10
4851,1,-9,-90,-15,6
4852,1,24,144,12,12
4853,1,-26,144,-18,-8
4854,1,11,-126,18,-7
4855,1,16,0,0,16
4856,1,6,-16,-2,8
4857,1,-6,-160,10,-16
4858,1,4,0,4,0
4859,1,-2,-120,-12,10
4860,1,2,1,1,1
4861,1,-29,190,-10,-19
4862,1,-31,240,-15,-16
4863,1,3,-340,20,-17
4864,1,7,12,4,3
4865,1,-7,-198,11,-18
4866,1,-28,180,-18,-10
4867,1,25,100,20,5
4868,1,-20,75,-5,-15
4869,1,2,-255,17,-15
4870,1,20,36,18,2
4871,1,11,-126,-7,18
4872,1,19,60,15,4
4873,1,-25,136,-17,-8
4874,1,3,-270,18,-15
4875,1,-33,266,-19,-14
4876,1,-2,-120,10,-12
4877,1,-18,72,-6,-12
4878,1,-1,-380,19,-20
4879,1,7,-260,-13,20
4880,1,-19,70,-14,-5
4881,1,8,-153,17,-9
4882,1,22,96,6,16
4883,1,7,-170,17,-10
4884,1,1,-182,14,-13
4885,1,-12,20,-10,-2
4886,1,-25,144,-9,-16
4887,1,-24,140,-10,-14
4888,1,31,220,11,20
4889,1,18,-40,-2,20
4890,1,-6,9,-3,-3
4891,1,10,-24,-2,12
4892,1,-11,-42,3,-14
4893,1,5,-84,12,-7
4894,1,-2,-360,-20,18
4895,1,13,-90,-5,18
4896,1,-16,60,-10,-6
4897,1,19,0,19,0
4898,1,11,18,9,2
4899,1,0,-36,6,-6
4900,1,-22,40,-20,-2
4901,1,-21,80,-16,-5
4902,1,-21,68,-4,-17
4903,1,-30,209,-19,-11
4904,1,-13,-14,-14,1
4905,1,-13,22,-11,-2
4906,1,-2,-35,5,-7
4907,1,7,-170,-10,17
4908,1,16,-36,18,-2
4909,1,16,48,4,12
4910,1,15,-100,-5,20
4911,1,-5,-50,-10,5
4912,1,-16,0,0,-16
4913,1,29,208,13,16
4914,1,16,55,11,5
4915,1,2,-80,-8,10
4916,1,12,35,5,7
4917,1,-13,42,-6,-7
4918,1,7,-8,8,-1
4919,1,26,153,9,17
4920,1,4,0,4,0
4921,1,22,112,8,14
4922,1,-23,132,-12,-11
4923,1,-6,-135,9,-15
4924,1,-12,32,-4,-8
4925,1,36,324,18,18
4926,1,-6,-55,5,-11
4927,1,-4,-285,15,-19
4928,1,-14,-15,-15,1
4929,1,-18,0,-18,0
4930,1,-32,240,-12,-20
4931,1,-19,84,-12,-7
4932,1,16,-17,17,-1
4933,1,1,-110,-10,11
4934,1,8,-153,-9,17
4935,1,15,-54,18,-3
4936,1,21,98,7,14
4937,1,34,280,20,14
4938,1,31,238,14,17
4939,1,6,-7,7,-1
4940,1,-12,-45,-15,3
4941,1,-10,24,-6,-4
4942,1,-20,51,-17,-3
4943,1,-7,-30,-10,3
4944,1,20,0,20,0
4945,1,-17,52,-13,-4
4946,1,7,-8,8,-1
4947,1,7,-8,-1,8
4948,1,3,-108,-9,12
4949,1,-6,-280,-20,14
4950,1,-25,154,-11,-14
4951,1,27,182,14,13
4952,1,14,33,11,3
4953,1,20,75,5,15
4954,1,-3,-208,-16,13
4955,1,-13,-14,-14,1
4956,1,-17,52,-13,-4
4957,1,-10,9,-9,-1
4958,1,-10,-96,6,-16
4959,1,-31,220,-20,-11
4960,1,8,-20,-2,10
4961,1,28,180,18,10
4962,1,6,-187,-11,17
4963,1,7,-98,-7,14
4964,1,0,-256,16,-16
4965,1,-6,5,-5,-1
4966,1,3,-10,5,-2
4967,1,-10,-144,8,-18
4968,1,-10,-200,10,-20
4969,1,23,90,5,18
4970,1,29,210,14,15
4971,1,-15,26,-2,-13
4972,1,-26,165,-11,-15
4973,1,29,190,19,10
4974,1,-24,140,-10,-14
4975,1,21,80,16,5
4976,1,-13,30,-10,-3
4977,1,-28,160,-20,-8
4978,1,7,-144,-9,16
4979,1,8,-48,-4,12
4980,1,2,-8,-2,4
4981,1,-6,-187,-17,11
4982,1,1,-20,5,-4
4983,1,1,-182,14,-13
4984,1,-7,-144,-16,9
4985,1,-17,0,-17,0
4986,1,10,21,7,3
4987,1,-1,-272,16,-17
4988,1,-9,-52,4,-13
4989,1,-26,133,-7,-19
4990,1,-9,-22,-11,2
4991,1,3,-108,-9,12
4992,1,18,77,11,7
4993,1,-20,36,-18,-2
4994,1,16,63,7,9
4995,1,26,153,9,17
4996,1,18,80,8,10
4997,1,-18,80,-8,-10
4998,1,27,162,9,18
4999,1,4,-221,17,-13
5000,1,10,21,7,3
5001,1,-29,190,-19,-10
5002,1,-6,-216,12,-18
5003,1,4,-285,-15,19
5004,1,-1,-182,13,-14
5005,1,15,50,5,10
5006,1,12,-133,19,-7
5007,1,3,-28,7,-4
5008,1,20,96,8,12
5009,1,9,-22,-2,11
5010,1,-13,-90,5,-18
5011,1,8,-180,18,-10
5012,1,-20,64,-4,-16
5013,1,-4,-5,-5,1
5014,1,11,10,1,10
5015,1,14,48,8,6
5016,1,23,126,14,9
5017,1,-2,-323,-19,17
5018,1,9,8,8,1
5019,1,-12,-160,8,-20
5020,1,27,176,11,16
5021,1,-9,-70,-14,5
5022,1,20,91,7,13
5023,1,16,0,16,0
5024,1,4,4,2,2
5025,1,-1,-6,2,-3
5026,1,33,272,16,17
5027,1,-5,-126,9,-14
5028,1,-11,18,-9,-2
5029,1,-7,-8,1,-8
5030,1,-1,-12,3,-4
5031,1,13,42,7,6
5032,1,-19,70,-5,-14
5033,1,-3,-304,-19,16
5034,1,-11,-26,2,-13
5035,1,-6,5,-1,-5
5036,1,17,30,15,2
5037,1,33,270,18,15
5038,1,23,120,15,8
5039,1,29,210,15,14
5040,1,-21,90,-6,-15
5041,1,-13,-48,-16,3
5042,1,-8,16,-4,-4
5043,1,6,-27,-3,9
5044,1,-8,7,-1,-7
5045,1,9,-112,-7,16
5046,1,13,-14,14,-1
5047,1,15,44,11,4
5048,1,12,35,7,5
5049,1,25,126,18,7
5050,1,-34,285,-15,-19
5051,1,4,-21,-3,7
5052,1,4,-117,-9,13
5053,1,10,16,2,8
5054,1,-6,5,-1,-5
5055,1,9,18,3,6
5056,1,16,0,16,0
5057,1,32,255,15,17
5058,1,24,143,11,13
5059,1,-24,80,-20,-4
5060,1,0,-324,-18,18
5061,1,-25,114,-6,-19
5062,1,12,-133,19,-7
5063,1,-3,-180,-15,12
5064,1,-36,323,-17,-19
5065,1,-13,0,0,-13
5066,1,-33,270,-18,-15
5067,1,-32,252,-18,-14
5068,1,18,17,17,1
5069,1,19,0,0,19
5070,1,-5,6,-3,-2
5071,1,9,-22,11,-2
5072,1,13,-30,-2,15
5073,1,-8,-180,10,-18
5074,1,-9,-220,-20,11
5075,1,-14,-120,-20,6
5076,1,-22,96,-6,-16
5077,1,17,60,5,12
5078,1,-25,126,-18,-7
5079,1,-32,247,-13,-19
5080,1,26,133,19,7
5081,1,24,143,11,13
5082,1,3,-54,-6,9
5083,1,19,78,13,6
5084,1,-3,-208,-16,13
5085,1,-9,-52,4,-13
5086,1,-26,168,-14,-12
5087,1,7,-30,-3,10
5088,1,12,20,2,10
5089,1,-8,-65,-13,5
5090,1,-28,195,-15,-13
5091,1,-9,-112,7,-16
5092,1,-13,22,-2,-11
5093,1,-3,-4,1,-4
5094,1,-32,247,-19,-13
5095,1,2,-80,10,-8
5096,1,-1,-306,17,-18
5097,1,-17,-38,-19,2
5098,1,-33,266,-19,-14
5099,1,13,40,8,5
5100,1,-1,-20,4,-5
5101,1,3,-70,10,-7
5102,1,-34,289,-17,-17
5103,1,17,-60,-3,20
5104,1,28,187,17,11
5105,1,-7,-260,13,-20
5106,1,-1,-272,16,-17
5107,1,1,-2,-1,2
5108,1,-2,-168,12,-14
5109,1,-12,-160,8,-20
5110,1,28,192,12,16
5111,1,-13,-90,5,-18
5112,1,-9,-22,-11,2
5113,1,-5,-176,-16,11
5114,1,-3,-270,-18,15
5115,1,-4,0,-4,0
5116,1,-25,126,-7,-18
5117,1,-22,121,-11,-11
5118,1,0,-49,7,-7
5119,1,6,-187,17,-11
5120,1,17,72,8,9
5121,1,4,-285,-15,19
5122,1,5,-234,-13,18
5123,1,9,-112,-7,16
5124,1,-1,-182,13,-14
5125,1,-4,-5,1,-5
5126,1,-5,-176,-16,11
5127,1,13,-14,-1,14
5128,1,-13,-30,-15,2
5129,1,-22,57,-19,-3
5130,1,-8,0,-8,0
5131,1,0,-361,-19,19
5132,1,2,-168,-12,14
5133,1,7,-170,17,-10
5134,1,20,91,13,7
5135,1,-12,20,-10,-2
5136,1,-1,-306,-18,17
5137,1,-6,-112,-14,8
5138,1,27,170,17,10
5139,1,-14,-15,-15,1
5140,1,6,9,3,3
5141,1,34,280,14,20
5142,1,-17,42,-3,-14
5143,1,17,60,5,12
5144,1,1,-30,6,-5
5145,1,15,14,1,14
5146,1,10,24,6,4
5147,1,-5,4,-4,-1
5148,1,-3,2,-1,-2
5149,1,35,304,16,19
5150,1,24,80,20,4
5151,1,-8,12,-2,-6
5152,1,3,2,2,1
5153,1,9,-90,-6,15
5154,1,28,196,14,14
5155,1,6,-187,17,-11
5156,1,26,168,14,12
5157,1,-12,27,-3,-9
5158,1,0,-324,-18,18
5159,1,-15,-100,-20,5
5160,1,18,0,18,0
5161,1,16,-36,18,-2
5162,1,10,-11,-1,11
5163,1,-22,96,-6,-16
5164,1,34,285,15,19
5165,1,17,30,15,2
5166,1,-33,266,-14,-19
5167,1,-26,165,-15,-11
5168,1,11,24,3,8
5169,1,1,-42,-6,7
5170,1,-13,12,-12,-1
5171,1,-3,-70,-10,7
5172,1,15,14,14,1
5173,1,7,-198,-11,18
5174,1,-17,-38,-19,2
5175,1,13,-114,19,-6
5176,1,-25,144,-16,-9
5177,1,-6,-160,10,-16
5178,1,-16,48,-4,-12
5179,1,-12,32,-4,-8
5180,1,34,288,16,18
5181,1,-30,225,-15,-15
5182,1,-22,40,-20,-2
5183,1,-2,1,-1,-1
5184,1,4,-117,-9,13
5185,1,16,-36,18,-2
5186,1,10,-96,-6,16
5187,1,-33,266,-19,-14
5188,1,-2,-24,-6,4
5189,1,-31,220,-11,-20
5190,1,-8,-84,6,-14
5191,1,-2,-323,17,-19
5192,1,13,36,4,9
5193,1,23,90,18,5
5194,1,9,-70,-5,14
5195,1,-28,192,-12,-16
5196,1,-18,0,0,-18
5197,1,-10,0,-10,0
5198,1,9,18,6,3
5199,1,0,-121,-11,11
5200,1,-20,99,-11,-9
5201,1,-17,70,-7,-10
5202,1,32,256,16,16
5203,1,-24,80,-4,-20
5204,1,28,160,20,8
5205,1,-8,-84,-14,6
5206,1,1,-272,-16,17
5207,1,3,-108,12,-9
5208,1,36,324,18,18
5209,1,-4,-45,-9,5
5210,1,17,70,7,10
5211,1,10,-96,16,-6
5212,1,-1,-56,-8,7
5213,1,4,-5,5,-1
5214,1,3,-304,-16,19
5215,1,24,80,4,20
5216,1,23,132,11,12
5217,1,1,0,0,1
5218,1,18,81,9,9
5219,1,-30,216,-12,-18
5220,1,10,-144,-8,18
5221,1,13,-48,-3,16
5222,1,15,14,14,1
5223,1,28,160,8,20
5224,1,-10,-24,2,-12
5225,1,-16,-36,-18,2
5226,1,8,-240,-12,20
5227,1,9,18,3,6
5228,1,9,-52,-4,13
5229,1,-6,-216,12,-18
5230,1,-6,-40,-10,4
5231,1,-38,360,-18,-20
5232,1,-13,-30,-15,2
5233,1,-18,77,-11,-7
5234,1,-9,8,-8,-1
5235,1,-12,-160,-20,8
5236,1,-33,260,-13,-20
5237,1,-23,130,-10,-13
5238,1,3,-180,15,-12
5239,1,20,36,2,18
5240,1,3,-238,17,-14
5241,1,-17,72,-8,-9
5242,1,-14,40,-10,-4
5243,1,4,-285,-15,19
5244,1,25,150,10,15
5245,1,-2,-323,17,-19
5246,1,-23,112,-16,-7
5247,1,-22,117,-9,-13
5248,1,-2,-255,15,-17
5249,1,0,-144,-12,12
5250,1,-15,-16,1,-16
5251,1,-16,0,0,-16
5252,1,20,64,4,16
5253,1,10,9,9,1
5254,1,-2,-3,1,-3
5255,1,-11,-60,4,-15
5256,1,-17,70,-7,-10
5257,1,-25,154,-14,-11
5258,1,-2,-255,-17,15
5259,1,-9,8,-8,-1
5260,1,10,16,8,2
5261,1,9,-36,12,-3
5262,1,-1,-12,-4,3
5263,1,-14,-95,-19,5
5264,1,-30,200,-10,-20
5265,1,8,7,1,7
5266,1,17,30,2,15
5267,1,2,-15,5,-3
5268,1,-13,22,-11,-2
5269,1,20,96,12,8
5270,1,-19,78,-13,-6
5271,1,8,15,5,3
5272,1,2,-35,-5,7
5273,1,18,56,4,14
5274,1,22,96,6,16
5275,1,39,380,19,20
5276,1,34,285,19,15
5277,1,16,15,1,15
5278,1,14,-15,-1,15
5279,1,-19,18,-18,-1
5280,1,-11,-26,2,-13
5281,1,1,-20,-4,5
5282,1,17,72,9,8
5283,1,4,-140,-10,14
5284,1,22,72,18,4
5285,1,-1,-380,-20,19
5286,1,27,140,20,7
5287,1,10,0,10,0
5288,1,-2,-8,-4,2
5289,1,13,-114,-6,19
5290,1,-1,-342,-19,18
5291,1,-18,65,-13,-5
5292,1,4,-12,-2,6
5293,1,-15,-100,5,-20
5294,1,-4,0,0,-4
5295,1,35,300,20,15
5296,1,22,120,10,12
5297,1,-6,-55,5,-11
5298,1,-25,126,-18,-7
5299,1,15,-100,-5,20
5300,1,-10,-200,-20,10
5301,1,-4,-165,11,-15
5302,1,-5,-204,12,-17
5303,1,0,-25,5,-5
5304,1,-24,140,-10,-14
5305,1,8,-240,-12,20
5306,1,-21,80,-5,-16
5307,1,14,24,12,2
5308,1,-8,7,-1,-7
5309,1,20,51,17,3
5310,1,-13,-30,-15,2
5311,1,-22,112,-14,-8
5312,1,12,11,11,1
5313,1,32,256,16,16
5314,1,8,-65,-5,13
5315,1,33,272,16,17
5316,1,-1,-72,8,-9
5317,1,10,-39,-3,13
5318,1,-7,-170,-17,10
5319,1,13,40,5,8
5320,1,4,-60,-6,10
5321,1,-7,6,-6,-1
5322,1,8,15,3,5
5323,1,3,-40,8,-5
5324,1,-33,260,-20,-13
5325,1,-9,-136,-17,8
5326,1,-19,-20,-20,1
5327,1,2,-168,-12,14
5328,1,30,216,18,12
5329,1,18,72,6,12
5330,1,6,-27,-3,9
5331,1,-17,0,0,-17
5332,1,10,21,3,7
5333,1,-25,126,-18,-7
5334,1,-2,-35,5,-7
5335,1,-16,63,-7,-9
5336,1,-2,-168,-14,12
5337,1,2,-3,-1,3
5338,1,-4,-252,14,-18
5339,1,17,72,9,8
5340,1,-12,-85,5,-17
5341,1,6,5,1,5
5342,1,4,-140,-10,14
5343,1,32,240,20,12
5344,1,-1,-380,19,-20
5345,1,6,-55,11,-5
5346,1,-23,126,-9,-14
5347,1,3,-180,15,-12
5348,1,-36,320,-20,-16
5349,1,-1,-56,7,-8
5350,1,16,39,13,3
5351,1,13,-48,-3,16
5352,1,-30,216,-18,-12
5353,1,-40,400,-20,-20
5354,1,-6,-160,10,-16
5355,1,-4,-77,-11,7
5356,1,-33,272,-17,-16
5357,1,-12,-133,7,-19
5358,1,-13,42,-7,-6
5359,1,-29,210,-14,-15
5360,1,-13,22,-11,-2
5361,1,-3,-208,13,-16
5362,1,17,72,9,8
5363,1,22,57,19,3
5364,1,-4,-77,7,-11
5365,1,24,108,6,18
5366,1,-25,150,-15,-10
5367,1,20,84,6,14
5368,1,3,-70,10,-7
5369,1,-15,36,-12,-3
5370,1,2,-35,7,-5
5371,1,-9,-220,-20,11
5372,1,-24,140,-14,-10
5373,1,29,208,13,16
5374,1,-22,85,-17,-5
5375,1,-20,36,-18,-2
5376,1,-13,12,-12,-1
5377,1,7,10,5,2
5378,1,33,260,13,20
5379,1,7,-228,-12,19
5380,1,16,15,15,1
5381,1,-12,35,-7,-5
5382,1,17,72,9,8
5383,1,6,0,0,6
5384,1,-11,-152,-19,8
5385,1,-9,-136,-17,8
5386,1,-11,-42,-14,3
5387,1,-3,-108,9,-12
5388,1,2,-288,18,-16
5389,1,29,190,19,10
5390,1,12,20,10,2
5391,1,5,-66,-6,11
5392,1,-7,-78,6,-13
5393,1,18,77,7,11
5394,1,22,120,12,10
5395,1,16,63,9,7
5396,1,3,-180,15,-12
5397,1,11,-102,17,-6
5398,1,-25,114,-6,-19
5399,1,-14,-32,-16,2
5400,1,37,340,17,20
5401,1,-9,-162,9,-18
5402,1,15,26,2,13
5403,1,21,110,11,10
5404,1,5,-36,9,-4
5405,1,7,-170,-10,17
5406,1,-3,-304,16,-19
5407,1,17,70,7,10
5408,1,2,-15,-3,5
5409,1,17,16,1,16
5410,1,21,104,8,13
5411,1,-9,14,-2,-7
5412,1,-21,108,-12,-9
5413,1,-9,20,-5,-4
5414,1,-11,-26,-13,2
5415,1,7,-120,-8,15
5416,1,4,-320,20,-16
5417,1,-19,18,-18,-1
5418,1,19,34,17,2
5419,1,-2,-195,13,-15
5420,1,-31,238,-14,-17
5421,1,-26,153,-9,-17
5422,1,6,5,5,1
5423,1,-10,-39,-13,3
5424,1,11,28,4,7
5425,1,2,-24,6,-4
5426,1,-11,-42,3,-14
5427,1,-24,95,-19,-5
5428,1,-7,10,-5,-2
5429,1,15,26,2,13
5430,1,8,-33,-3,11
5431,1,-37,340,-17,-20
5432,1,16,28,2,14
5433,1,23,126,14,9
5434,1,5,-104,13,-8
5435,1,-9,14,-2,-7
5436,1,11,-126,18,-7
5437,1,0,-196,14,-14
5438,1,-6,-216,-18,12
5439,1,-26,120,-6,-20
5440,1,-10,0,-10,0
5441,1,-5,-204,-17,12
5442,1,-2,-63,-9,7
5443,1,30,224,14,16
5444,1,-31,220,-20,-11
5445,1,17,0,17,0
5446,1,0,-64,8,-8
5447,1,-9,-10,1,-10
5448,1,-8,-153,-17,9
5449,1,12,32,8,4
5450,1,11,-12,12,-1
5451,1,-35,300,-20,-15
5452,1,-7,-98,-14,7
5453,1,-5,4,-4,-1
5454,1,-3,-18,3,-6
5455,1,-1,-12,-4,3
5456,1,7,-8,8,-1
5457,1,28,195,15,13
5458,1,4,-320,20,-16
5459,1,-8,-84,6,-14
5460,1,-18,0,-18,0
5461,1,-20,75,-15,-5
5462,1,-23,76,-19,-4
5463,1,13,-114,19,-6
5464,1,29,180,9,20
5465,1,-3,-340,17,-20
5466,1,-16,-80,-20,4
5467,1,4,-32,8,-4
5468,1,-2,-255,-17,15
5469,1,-15,36,-12,-3
5470,1,1,-42,-6,7
5471,1,34,285,15,19
5472,1,14,-120,-6,20
5473,1,0,-121,-11,11
5474,1,7,-60,-5,12
5475,1,1,-240,-15,16
5476,1,14,45,9,5
5477,1,-23,76,-4,-19
5478,1,2,-99,11,-9
5479,1,14,-72,18,-4
5480,1,-2,-15,3,-5
5481,1,12,-85,-5,17
5482,1,-11,-26,-13,2
5483,1,6,9,3,3
5484,1,-21,104,-8,-13
5485,1,0,-25,5,-5
5486,1,8,16,4,4
5487,1,15,56,8,7
5488,1,25,126,7,18
5489,1,29,208,13,16
5490,1,1,-56,-7,8
5491,1,-11,-126,-18,7
5492,1,-15,14,-14,-1
5493,1,-7,-60,-12,5
5494,1,-30,224,-14,-16
5495,1,3,-88,-8,11
5496,1,-17,0,-17,0
5497,1,25,156,12,13
5498,1,-27,162,-9,-18
5499,1,23,102,17,6
5500,1,-30,216,-18,-12
5501,1,16,28,2,14
5502,1,2,-323,19,-17
5503,1,7,-228,-12,19
5504,1,0,-49,-7,7
5505,1,12,20,10,2
5506,1,-6,-91,-13,7
5507,1,18,17,17,1
5508,1,-9,-10,-10,1
5509,1,-12,36,-6,-6
5510,1,-5,-176,11,-16
5511,1,38,360,20,18
5512,1,-22,57,-19,-3
5513,1,2,-120,-10,12
5514,1,-2,-120,-12,10
5515,1,7,-198,18,-11
5516,1,-13,30,-10,-3
5517,1,9,18,3,6
5518,1,4,-5,-1,5
5519,1,38,360,18,20
5520,1,-3,-88,8,-11
5521,1,-22,96,-6,-16
5522,1,-13,-68,-17,4
5523,1,28,160,20,8
5524,1,-6,-55,-11,5
5525,1,25,126,7,18
5526,1,-12,-160,8,-20
5527,1,-2,-99,9,-11
5528,1,-5,-176,-16,11
5529,1,2,-255,17,-15
5530,1,29,210,15,14
5531,1,-14,48,-8,-6
5532,1,-10,-171,9,-19
5533,1,-18,17,-1,-17
5534,1,12,-45,-3,15
5535,1,11,28,7,4
5536,1,-20,100,-10,-10
5537,1,-17,66,-11,-6
5538,1,-14,-72,4,-18
5539,1,16,60,6,10
5540,1,20,19,19,1
5541,1,17,42,3,14
5542,1,-16,39,-13,-3
5543,1,20,75,5,15
5544,1,-37,342,-18,-19
5545,1,16,48,12,4
5546,1,16,39,13,3
5547,1,-2,-168,12,-14
5548,1,10,-24,12,-2
5549,1,31,228,19,12
5550,1,-22,72,-18,-4
5551,1,38,361,19,19
5552,1,-32,247,-19,-13
5553,1,22,112,14,8
5554,1,-22,96,-16,-6
5555,1,6,-7,7,-1
5556,1,0,-324,18,-18
5557,1,-16,15,-1,-15
5558,1,-25,136,-8,-17
5559,1,17,70,10,7
5560,1,19,18,1,18
5561,1,23,132,11,12
5562,1,-16,48,-12,-4
5563,1,-2,-360,-20,18
5564,1,-5,-266,14,-19
5565,1,-5,-234,-18,13
5566,1,3,0,0,3
5567,1,-15,36,-3,-12
5568,1,-8,12,-6,-2
5569,1,-20,84,-14,-6
5570,1,-22,57,-19,-3
5571,1,-22,40,-20,-2
5572,1,-12,35,-7,-5
5573,1,-5,-36,-9,4
5574,1,-16,39,-13,-3
5575,1,9,14,2,7
5576,1,-11,0,-11,0
5577,1,9,20,4,5
5578,1,14,48,6,8
5579,1,22,96,6,16
5580,1,-2,-168,12,-14
5581,1,-25,150,-10,-15
5582,1,5,-176,16,-11
5583,1,3,-88,-8,11
5584,1,2,-120,-10,12
5585,1,11,-180,-9,20
5586,1,-3,-270,-18,15
5587,1,3,-108,-9,12
5588,1,2,-288,18,-16
5589,1,-8,-105,-15,7
5590,1,5,-104,13,-8
5591,1,16,-80,20,-4
5592,1,2,-143,-11,13
5593,1,10,-119,17,-7
5594,1,-10,-24,-12,2
5595,1,-22,96,-6,-16
5596,1,2,-224,-14,16
5597,1,8,0,0,8
5598,1,-18,77,-11,-7
5599,1,-13,30,-10,-3
5600,1,0,-225,15,-15
5601,1,1,-306,18,-17
5602,1,-15,26,-2,-13
5603,1,-27,170,-17,-10
5604,1,-15,50,-10,-5
5605,1,13,-114,19,-6
5606,1,24,135,15,9
5607,1,-33,272,-17,-16
5608,1,29,198,18,11
5609,1,-27,170,-17,-10
5610,1,-1,-240,15,-16
5611,1,-6,-7,1,-7
5612,1,-17,16,-1,-16
5613,1,-7,-198,-18,11
5614,1,-22,105,-15,-7
5615,1,-21,104,-8,-13
5616,1,22,40,20,2
5617,1,8,-153,-9,17
5618,1,8,-65,-5,13
5619,1,-3,-10,-5,2
5620,1,13,-14,14,-1
5621,1,17,66,11,6
5622,1,-10,-56,4,-14
5623,1,-14,-32,2,-16
5624,1,-5,0,-5,0
5625,1,4,-165,-11,15
5626,1,21,68,17,4
5627,1,3,-10,5,-2
5628,1,7,-144,16,-9
5629,1,-18,80,-8,-10
5630,1,6,-7,-1,7
5631,1,-7,12,-4,-3
5632,1,1,-6,3,-2
5633,1,17,-60,-3,20
5634,1,-6,-112,8,-14
5635,1,39,380,20,19
5636,1,18,81,9,9
5637,1,38,360,18,20
5638,1,-32,255,-17,-15
5639,1,34,288,18,16
5640,1,15,-54,18,-3
5641,1,13,36,9,4
5642,1,-29,180,-9,-20
5643,1,8,-65,13,-5
5644,1,-15,36,-3,-12
5645,1,31,238,14,17
5646,1,-5,4,-1,-4
5647,1,24,95,19,5
5648,1,33,272,16,17
5649,1,4,-12,-2,6
5650,1,12,11,11,1
5651,1,9,-22,11,-2
5652,1,19,18,1,18
5653,1,-15,-54,-18,3
5654,1,-18,65,-5,-13
5655,1,17,42,14,3
5656,1,-9,8,-8,-1
5657,1,-18,56,-4,-14
5658,1,-8,-240,12,-20
5659,1,6,-91,-7,13
5660,1,-6,-27,-9,3
5661,1,-18,17,-17,-1
5662,1,-21,54,-3,-18
5663,1,-30,216,-18,-12
5664,1,-5,-14,-7,2
5665,1,-22,72,-18,-4
5666,1,2,-168,-12,14
5667,1,8,-180,18,-10
5668,1,17,70,7,10
5669,1,-10,-56,-14,4
5670,1,26,165,15,11
5671,1,5,-204,-12,17
5672,1,0,-121,11,-11
5673,1,6,-216,-12,18
5674,1,9,-70,-5,14
5675,1,-3,-208,13,-16
5676,1,7,12,3,4
5677,1,4,3,1,3
5678,1,-15,-54,3,-18
5679,1,-28,171,-19,-9
5680,1,10,21,7,3
5681,1,-20,64,-4,-16
5682,1,22,120,10,12
5683,1,8,-33,-3,11
5684,1,-9,-22,-11,2
5685,1,9,-36,-3,12
5686,1,-23,76,-19,-4
5687,1,-3,-18,3,-6
5688,1,34,280,14,20
5689,1,12,20,10,2
5690,1,0,-1,-1,1
5691,1,-32,247,-13,-19
5692,1,16,0,16,0
5693,1,5,-126,-9,14
5694,1,-7,-144,-16,9
5695,1,-24,128,-16,-8
5696,1,-17,-38,2,-19
5697,1,-23,102,-6,-17
5698,1,15,0,15,0
5699,1,1,-20,-4,5
5700,1,-7,10,-5,-2
5701,1,-11,-26,2,-13
5702,1,33,272,17,16
5703,1,16,48,4,12
5704,1,1,-380,20,-19
5705,1,9,-22,-2,11
5706,1,-1,-12,-4,3
5707,1,-3,-28,-7,4
5708,1,11,-180,-9,20
5709,1,1,0,0,1
5710,1,26,165,15,11
5711,1,27,162,9,18
5712,1,12,20,2,10
5713,1,30,224,16,14
5714,1,-9,-220,-20,11
5715,1,-5,-84,7,-12
5716,1,-14,13,-1,-13
5717,1,28,160,8,20
5718,1,-24,119,-7,-17
5719,1,14,-32,16,-2
5720,1,-28,187,-17,-11
5721,1,-15,0,0,-15
5722,1,12,0,12,0
5723,1,-2,-195,13,-15
5724,1,7,6,6,1
5725,1,17,0,17,0
5726,1,5,-14,7,-2
5727,1,-13,0,0,-13
5728,1,13,-30,15,-2
5729,1,-20,91,-7,-13
5730,1,13,-140,20,-7
5731,1,-7,-98,7,-14
5732,1,-1,-110,-11,10
5733,1,-8,16,-4,-4
5734,1,4,-117,13,-9
5735,1,0,0,0,0
5736,1,-11,30,-6,-5
5737,1,-11,-42,3,-14
5738,1,5,-150,-10,15
5739,1,-8,-48,-12,4
5740,1,4,-77,11,-7
5741,1,-24,95,-5,-19
5742,1,2,-195,-13,15
5743,1,-18,77,-11,-7
5744,1,-7,-198,11,-18
5745,1,-6,-27,3,-9
5746,1,13,-68,-4,17
5747,1,20,0,20,0
5748,1,-13,-48,3,-16
5749,1,-31,228,-12,-19
5750,1,19,18,18,1
5751,1,22,85,5,17
5752,1,-23,112,-7,-16
5753,1,-17,42,-14,-3
5754,1,-26,153,-17,-9
5755,1,5,-84,-7,12
5756,1,23,126,14,9
5757,1,-9,-10,-10,1
5758,1,-29,204,-17,-12
5759,1,1,-342,19,-18
5760,1,13,40,5,8
5761,1,-12,32,-4,-8
5762,1,1,-272,17,-16
5763,1,-11,0,-11,0
5764,1,9,18,3,6
5765,1,-7,-8,-8,1
5766,1,17,-38,19,-2
5767,1,-26,168,-14,-12
5768,1,19,0,0,19
5769,1,-10,21,-7,-3
5770,1,10,-75,-5,15
5771,1,5,-176,-11,16
5772,1,-1,-132,11,-12
5773,1,-1,-20,4,-5
5774,1,33,266,19,14
5775,1,35,300,20,15
5776,1,-20,64,-16,-4
5777,1,-1,-380,19,-20
5778,1,18,-40,20,-2
5779,1,5,6,3,2
5780,1,-5,-234,13,-18
5781,1,-29,210,-14,-15
5782,1,5,-66,-6,11
5783,1,20,99,11,9
5784,1,9,-90,15,-6
5785,1,1,-156,13,-12
5786,1,32,240,12,20
5787,1,-2,-323,17,-19
5788,1,-7,-98,7,-14
5789,1,-16,39,-13,-3
5790,1,-11,-80,-16,5
5791,1,22,117,13,9
5792,1,-16,48,-4,-12
5793,1,-11,-42,-14,3
5794,1,-11,-42,-14,3
5795,1,-25,144,-9,-16
5796,1,-22,117,-9,-13
5797,1,16,-57,-3,19
5798,1,29,204,12,17
5799,1,11,10,10,1
5800,1,-9,14,-7,-2
5801,1,6,-187,17,-11
5802,1,-18,0,0,-18
5803,1,20,36,2,18
5804,1,13,-48,-3,16
5805,1,0,-144,12,-12
5806,1,11,30,6,5
5807,1,4,-285,-15,19
5808,1,-10,-39,3,-13
5809,1,21,80,5,16
5810,1,-33,260,-20,-13
5811,1,11,30,5,6
5812,1,18,80,8,10
5813,1,8,-128,-8,16
5814,1,4,-221,17,-13
5815,1,-11,-26,-13,2
5816,1,1,-110,11,-10
5817,1,-12,32,-8,-4
5818,1,15,56,8,7
5819,1,31,228,12,19
5820,1,-11,-42,-14,3
5821,1,14,0,14,0
5822,1,27,170,17,10
5823,1,25,150,10,15
5824,1,-21,110,-11,-10
5825,1,16,55,11,5
5826,1,-8,-240,-20,12
5827,1,4,-32,-4,8
5828,1,-30,224,-14,-16
5829,1,-6,-91,7,-13
5830,1,12,-64,-4,16
5831,1,-2,-224,-16,14
5832,1,10,9,1,9
5833,1,-5,-84,7,-12
5834,1,11,24,3,8
5835,1,-4,-285,15,-19
5836,1,-18,-40,-20,2
5837,1,17,70,7,10
5838,1,-1,-210,14,-15
5839,1,-35,306,-17,-18
5840,1,-7,6,-6,-1
5841,1,19,90,9,10
5842,1,-7,12,-3,-4
5843,1,19,90,10,9
5844,1,13,-30,-2,15
5845,1,-35,304,-19,-16
5846,1,9,14,2,7
5847,1,-13,-14,-14,1
5848,1,8,15,5,3
5849,1,29,190,10,19
5850,1,-3,-54,6,-9
5851,1,27,182,14,13
5852,1,23,60,3,20
5853,1,4,-320,20,-16
5854,1,36,324,18,18
5855,1,-30,224,-14,-16
5856,1,3,-88,-8,11
5857,1,-6,5,-5,-1
5858,1,-11,0,-11,0
5859,1,-33,266,-14,-19
5860,1,-37,340,-20,-17
5861,1,9,-22,-2,11
5862,1,23,120,8,15
5863,1,6,0,0,6
5864,1,20,51,3,17
5865,1,21,98,7,14
5866,1,24,135,15,9
5867,1,-23,126,-14,-9
5868,1,8,12,6,2
5869,1,26,120,6,20
5870,1,-10,-39,3,-13
5871,1,9,14,2,7
5872,1,-15,36,-12,-3
5873,1,21,98,14,7
5874,1,-28,160,-8,-20
5875,1,-7,10,-5,-2
5876,1,-6,5,-1,-5
5877,1,-11,-26,2,-13
5878,1,32,240,12,20
5879,1,-16,-17,1,-17
5880,1,-3,-40,5,-8
5881,1,-7,-98,7,-14
5882,1,4,-12,6,-2
5883,1,15,14,14,1
5884,1,10,21,3,7
5885,1,31,238,17,14
5886,1,22,85,5,17
5887,1,-25,126,-7,-18
5888,1,-32,252,-14,-18
5889,1,-28,187,-11,-17
5890,1,20,51,3,17
5891,1,-28,180,-18,-10
5892,1,11,0,11,0
5893,1,-30,224,-16,-14
5894,1,-4,3,-3,-1
5895,1,-3,-180,12,-15
5896,1,3,2,1,2
5897,1,8,-128,16,-8
5898,1,-21,68,-4,-17
5899,1,-8,-20,2,-10
5900,1,-18,56,-14,-4
5901,1,14,0,14,0
5902,1,-11,30,-5,-6
5903,1,-5,-266,-19,14
5904,1,3,-54,-6,9
5905,1,-6,-247,-19,13
5906,1,-16,-80,4,-20
5907,1,8,-180,18,-10
5908,1,8,-65,-5,13
5909,1,-18,45,-15,-3
5910,1,16,63,9,7
5911,1,-5,-24,-8,3
5912,1,-31,240,-15,-16
5913,1,5,4,1,4
5914,1,12,-85,-5,17
5915,1,10,0,0,10
5916,1,30,221,17,13
5917,1,-17,42,-14,-3
5918,1,-30,216,-12,-18
5919,1,-37,340,-17,-20
5920,1,1,-30,-5,6
5921,1,-4,0,-4,0
5922,1,-13,-140,7,-20
5923,1,4,-5,5,-1
5924,1,23,60,3,20
5925,1,-7,0,-7,0
5926,1,19,70,5,14
5927,1,-23,102,-6,-17
5928,1,-4,-45,-9,5
5929,1,23,102,6,17
5930,1,8,-9,-1,9
5931,1,-33,270,-18,-15
5932,1,19,34,17,2
5933,1,17,52,13,4
5934,1,-32,256,-16,-16
5935,1,14,-51,-3,17
5936,1,-3,-340,17,-20
5937,1,13,-140,20,-7
5938,1,26,133,7,19
5939,1,12,11,11,1
5940,1,20,19,1,19
5941,1,-35,304,-19,-16
5942,1,1,-210,-14,15
5943,1,-13,-68,4,-17
5944,1,-13,22,-2,-11
5945,1,5,-204,-12,17
5946,1,-18,17,-1,-17
5947,1,35,304,19,16
5948,1,-7,-228,-19,12
5949,1,8,-180,-10,18
5950,1,11,-180,-9,20
5951,1,15,-76,19,-4
5952,1,-11,18,-9,-2
5953,1,-17,-60,3,-20
5954,1,21,108,12,9
5955,1,-23,130,-10,-13
5956,1,-5,-300,15,-20
5957,1,31,240,16,15
5958,1,-16,39,-3,-13
5959,1,1,0,0,1
5960,1,-4,-192,12,-16
5961,1,-11,-60,-15,4
5962,1,-5,-66,6,-11
5963,1,23,102,17,6
5964,1,-8,-180,-18,10
5965,1,3,-28,-4,7
5966,1,16,0,0,16
5967,1,32,247,13,19
5968,1,23,90,18,5
5969,1,3,-70,-7,10
5970,1,-7,-30,-10,3
5971,1,-1,-42,-7,6
5972,1,-36,323,-17,-19
5973,1,-1,-20,-5,4
5974,1,1,-56,8,-7
5975,1,-34,288,-18,-16
5976,1,-13,0,0,-13
5977,1,8,-128,-8,16
5978,1,3,-238,17,-14
5979,1,7,-228,19,-12
5980,1,9,-112,-7,16
5981,1,-18,17,-1,-17
5982,1,10,24,6,4
5983,1,2,-99,-9,11
5984,1,33,260,20,13
5985,1,20,84,6,14
5986,1,12,0,12,0
5987,1,-17,30,-2,-15
5988,1,-9,-136,-17,8
5989,1,14,45,9,5
5990,1,-4,-165,-15,11
5991,1,-4,-285,15,-19
5992,1,19,48,3,16
5993,1,3,-304,19,-16
5994,1,15,56,7,8
5995,1,-17,0,0,-17
5996,1,8,-33,-3,11
5997,1,-23,112,-7,-16
5998,1,20,51,3,17
5999,1,5,-66,11,-6
6000,1,-6,-40,-10,4
6001,1,-17,0,-17,0
6002,1,25,144,9,16
6003,1,-6,-72,6,-12
6004,1,-10,9,-9,-1
6005,1,-10,-200,10,-20
6006,1,-24,143,-11,-13
6007,1,-2,-120,-12,10
6008,1,16,-80,-4,20
6009,1,7,-8,8,-1
6010,1,15,50,10,5
6011,1,-8,-153,9,-17
6012,1,-1,-156,12,-13
6013,1,9,-136,17,-8
6014,1,20,36,2,18
6015,1,9,-162,-9,18
6016,1,-1,-12,3,-4
6017,1,-3,-28,-7,4
6018,1,19,18,18,1
6019,1,-23,132,-12,-11
6020,1,11,10,1,10
6021,1,-19,48,-3,-16
6022,1,-5,-150,10,-15
6023,1,27,140,7,20
6024,1,9,-162,18,-9
6025,1,13,30,3,10
6026,1,5,-234,-13,18
6027,1,-25,100,-5,-20
6028,1,19,18,1,18
6029,1,-16,60,-6,-10
6030,1,-3,-130,10,-13
6031,1,11,-102,-6,17
6032,1,20,36,2,18
6033,1,15,36,12,3
6034,1,24,95,5,19
6035,1,-11,0,0,-11
6036,1,-11,28,-7,-4
6037,1,25,136,17,8
6038,1,5,-24,-3,8
6039,1,-15,0,0,-15
6040,1,-38,360,-18,-20
6041,1,-21,38,-2,-19
6042,1,-3,-340,-20,17
6043,1,-36,324,-18,-18
6044,1,5,-176,-11,16
6045,1,-30,216,-18,-12
6046,1,-3,-304,-19,16
6047,1,10,-200,-10,20
6048,1,-8,-180,10,-18
6049,1,18,32,2,16
6050,1,0,-16,-4,4
6051,1,9,-136,-8,17
6052,1,-9,0,-9,0
6053,1,-34,288,-16,-18
6054,1,4,3,1,3
6055,1,-9,18,-3,-6
6056,1,-13,-30,2,-15
6057,1,-18,-19,1,-19
6058,1,15,26,2,13
6059,1,-3,-18,3,-6
6060,1,-5,-36,-9,4
6061,1,-34,280,-20,-14
6062,1,-1,-132,11,-12
6063,1,-6,-55,5,-11
6064,1,23,126,9,14
6065,1,-13,-30,2,-15
6066,1,6,-27,-3,9
6067,1,8,-180,-10,18
6068,1,4,-140,-10,14
6069,1,-20,100,-10,-10
6070,1,3,-340,20,-17
6071,1,-19,-20,-20,1
6072,1,-15,-76,-19,4
6073,1,2,-168,14,-12
6074,1,-15,-100,5,-20
6075,1,20,99,11,9
6076,1,27,162,9,18
6077,1,-10,-39,3,-13
6078,1,-24,95,-5,-19
6079,1,9,-36,-3,12
6080,1,21,20,1,20
6081,1,-21,90,-15,-6
6082,1,-33,260,-13,-20
6083,1,10,16,2,8
6084,1,11,30,5,6
6085,1,-15,56,-7,-8
6086,1,1,-306,18,-17
6087,1,-24,135,-15,-9
6088,1,-23,90,-18,-5
6089,1,-22,117,-9,-13
6090,1,14,48,8,6
6091,1,14,13,13,1
6092,1,-7,-8,-8,1
6093,1,-15,26,-2,-13
6094,1,19,0,0,19
6095,1,-24,128,-8,-16
6096,1,22,117,13,9
6097,1,15,-16,-1,16
6098,1,-18,56,-14,-4
6099,1,18,56,4,14
6100,1,-37,340,-17,-20
6101,1,6,-72,-6,12
6102,1,-29,210,-14,-15
6103,1,-31,220,-11,-20
6104,1,-14,45,-5,-9
6105,1,-21,54,-18,-3
6106,1,-2,-80,8,-10
6107,1,-32,240,-20,-12
6108,1,-11,30,-5,-6
6109,1,0,-36,6,-6
6110,1,35,300,15,20
6111,1,-5,-300,15,-20
6112,1,-30,221,-17,-13
6113,1,1,-2,-1,2
6114,1,-12,-45,-15,3
6115,1,5,-150,15,-10
6116,1,-8,-209,-19,11
6117,1,18,32,2,16
6118,1,-22,112,-14,-8
6119,1,-22,40,-20,-2
6120,1,5,-104,-8,13
6121,1,-29,180,-9,-20
6122,1,12,-13,13,-1
6123,1,-26,160,-16,-10
6124,1,2,-24,6,-4
6125,1,-5,-14,2,-7
6126,1,17,70,10,7
6127,1,4,-45,9,-5
6128,1,-28,171,-19,-9
6129,1,27,170,17,10
6130,1,8,-153,17,-9
6131,1,-1,-42,6,-7
6132,1,4,-60,10,-6
6133,1,-11,-26,-13,2
6134,1,23,90,5,18
6135,1,-7,-8,-8,1
6136,1,-2,-35,-7,5
6137,1,13,30,3,10
6138,1,-23,130,-10,-13
6139,1,28,192,12,16
6140,1,0,-289,17,-17
6141,1,-9,20,-5,-4
6142,1,-33,260,-13,-20
6143,1,-17,-18,1,-18
6144,1,-23,126,-14,-9
6145,1,11,18,2,9
6146,1,-12,35,-7,-5
6147,1,28,160,20,8
6148,1,0,-121,11,-11
6149,1,-4,-165,11,-15
6150,1,-18,45,-3,-15
6151,1,30,200,20,10
6152,1,-8,12,-6,-2
6153,1,15,44,4,11
6154,1,10,-144,-8,18
6155,1,-16,-80,4,-20
6156,1,5,-204,-12,17
6157,1,-4,-221,13,-17
6158,1,6,-16,-2,8
6159,1,5,-234,-13,18
6160,1,12,-108,18,-6
6161,1,5,-36,9,-4
6162,1,9,-136,17,-8
6163,1,-10,-75,-15,5
6164,1,-12,-28,-14,2
6165,1,29,198,11,18
6166,1,-2,-288,-18,16
6167,1,-12,-133,-19,7
6168,1,4,-285,19,-15
6169,1,3,0,3,0
6170,1,18,32,16,2
6171,1,12,36,6,6
6172,1,-1,-72,8,-9
6173,1,-7,10,-5,-2
6174,1,3,-88,-8,11
6175,1,16,-80,20,-4
6176,1,28,195,15,13
6177,1,-20,84,-14,-6
6178,1,-35,304,-19,-16
6179,1,1,-272,-16,17
6180,1,-25,100,-5,-20
6181,1,25,156,12,13
6182,1,10,-24,12,-2
6183,1,-8,16,-4,-4
6184,1,22,120,10,12
6185,1,-36,323,-19,-17
6186,1,-23,130,-13,-10
6187,1,6,-16,8,-2
6188,1,-11,-80,5,-16
6189,1,-3,-130,-13,10
6190,1,-5,-14,2,-7
6191,1,-22,96,-16,-6
6192,1,25,126,18,7
6193,1,-13,30,-10,-3
6194,1,19,78,6,13
6195,1,23,120,15,8
6196,1,9,-10,10,-1
6197,1,29,210,15,14
6198,1,-11,-80,-16,5
6199,1,3,-208,16,-13
6200,1,-1,-20,-5,4
6201,1,28,160,20,8
6202,1,3,-4,-1,4
6203,1,7,-8,8,-1
6204,1,-22,57,-3,-19
6205,1,15,-54,-3,18
6206,1,11,28,4,7
6207,1,21,80,5,16
6208,1,-7,-60,-12,5
6209,1,16,63,9,7
6210,1,-22,120,-12,-10
6211,1,-11,-126,7,-18
6212,1,-4,-96,-12,8
6213,1,24,135,15,9
6214,1,-22,72,-18,-4
6215,1,1,-2,-1,2
6216,1,-14,45,-9,-5
6217,1,4,4,2,2
6218,1,1,-182,-13,14
6219,1,-4,-252,-18,14
6220,1,-4,-5,-5,1
6221,1,-12,-133,-19,7
6222,1,27,180,12,15
6223,1,-3,-270,15,-18
6224,1,-30,216,-12,-18
6225,1,3,-70,-7,10
6226,1,0,-169,-13,13
6227,1,22,96,6,16
6228,1,-21,80,-5,-16
6229,1,-17,-18,-18,1
6230,1,9,-162,18,-9
6231,1,-11,-26,-13,2
6232,1,-23,112,-16,-7
6233,1,7,10,5,2
6234,1,-30,209,-19,-11
6235,1,-13,30,-3,-10
6236,1,-2,-143,11,-13
6237,1,2,-24,-4,6
6238,1,17,0,0,17
6239,1,9,-10,10,-1
6240,1,-8,-33,-11,3
6241,1,-11,-12,1,-12
6242,1,3,-40,8,-5
6243,1,7,-170,-10,17
6244,1,9,-220,-11,20
6245,1,-2,-168,-14,12
6246,1,14,45,5,9
6247,1,-7,-44,-11,4
6248,1,-26,133,-19,-7
6249,1,-12,11,-11,-1
6250,1,6,-112,14,-8
6251,1,-14,-32,-16,2
6252,1,13,-48,16,-3
6253,1,3,-10,5,-2
6254,1,8,-180,18,-10
6255,1,-5,-14,2,-7
6256,1,-16,48,-4,-12
6257,1,13,-140,-7,20
6258,1,19,78,13,6
6259,1,-10,-171,-19,9
6260,1,8,-9,-1,9
6261,1,17,42,14,3
6262,1,-28,180,-18,-10
6263,1,-17,0,0,-17
6264,1,17,30,15,2
6265,1,-21,54,-3,-18
6266,1,15,50,5,10
6267,1,-25,136,-8,-17
6268,1,-11,-26,-13,2
6269,1,5,-50,-5,10
6270,1,-2,-48,6,-8
6271,1,-14,-32,2,-16
6272,1,15,-16,-1,16
6273,1,1,-90,10,-9
6274,1,-10,21,-7,-3
6275,1,19,70,14,5
6276,1,0,-81,-9,9
6277,1,11,24,3,8
6278,1,14,13,13,1
6279,1,-4,-5,1,-5
6280,1,-24,80,-20,-4
6281,1,-3,-4,-4,1
6282,1,24,108,6,18
6283,1,7,-144,-9,16
6284,1,23,132,12,11
6285,1,0,-1,1,-1
6286,1,-22,121,-11,-11
6287,1,-4,-165,-15,11
6288,1,9,-52,13,-4
6289,1,27,170,10,17
6290,1,-22,117,-13,-9
6291,1,10,9,1,9
6292,1,3,-70,10,-7
6293,1,-19,88,-11,-8
6294,1,4,-140,-10,14
6295,1,1,-306,18,-17
6296,1,-4,-192,12,-16
6297,1,12,27,3,9
6298,1,17,52,4,13
6299,1,-6,-40,-10,4
6300,1,4,-140,14,-10
6301,1,-19,48,-16,-3
6302,1,-1,-6,2,-3
6303,1,7,6,1,6
6304,1,16,28,2,14
6305,1,14,45,5,9
6306,1,8,15,5,3
6307,1,28,180,10,18
6308,1,0,-1,-1,1
6309,1,-18,80,-8,-10
6310,1,15,54,9,6
6311,1,27,140,20,7
6312,1,34,285,19,15
6313,1,-11,18,-9,-2
6314,1,8,-180,18,-10
6315,1,4,-117,-9,13
6316,1,15,-16,-1,16
6317,1,-1,-20,-5,4
6318,1,-24,143,-13,-11
6319,1,-11,28,-4,-7
6320,1,-11,-12,-12,1
6321,1,34,280,14,20
6322,1,-6,-112,8,-14
6323,1,20,51,17,3
6324,1,30,224,16,14
6325,1,-2,-224,14,-16
6326,1,35,306,17,18
6327,1,-1,-72,8,-9
6328,1,-13,22,-11,-2
6329,1,0,-121,-11,11
6330,1,-25,144,-16,-9
6331,1,6,-112,14,-8
6332,1,-10,24,-4,-6
6333,1,1,-306,18,-17
6334,1,-10,-171,9,-19
6335,1,-7,-198,11,-18
6336,1,7,-8,8,-1
6337,1,-6,-247,13,-19
6338,1,-8,-153,9,-17
6339,1,17,0,17,0
6340,1,-6,-216,12,-18
6341,1,40,400,20,20
6342,1,8,-48,-4,12
6343,1,-32,247,-19,-13
6344,1,2,-15,-3,5
6345,1,-2,-3,-3,1
6346,1,-24,119,-7,-17
6347,1,-4,-60,6,-10
6348,1,25,114,19,6
6349,1,-16,-36,2,-18
6350,1,-20,75,-15,-5
6351,1,14,0,0,14
6352,1,-2,-48,6,-8
6353,1,33,266,14,19
6354,1,6,-72,-6,12
6355,1,13,-68,-4,17
6356,1,10,-200,20,-10
6357,1,-10,0,0,-10
6358,1,-9,-220,-20,11
6359,1,6,-27,9,-3
6360,1,-17,60,-5,-12
6361,1,9,-70,14,-5
6362,1,-14,-72,4,-18
6363,1,32,255,15,17
6364,1,-9,-22,-11,2
6365,1,10,-24,12,-2
6366,1,-2,-48,6,-8
6367,1,7,-228,-12,19
6368,1,20,0,20,0
6369,1,-7,0,0,-7
6370,1,-15,-16,-16,1
6371,1,3,-18,6,-3
6372,1,-36,323,-19,-17
6373,1,11,18,2,9
6374,1,7,0,0,7
6375,1,-8,16,-4,-4
6376,1,-15,-76,-19,4
6377,1,20,75,15,5
6378,1,-7,-170,-17,10
6379,1,-9,20,-5,-4
6380,1,-12,-64,4,-16
6381,1,14,33,3,11
6382,1,-19,-20,-20,1
6383,1,-5,-234,13,-18
6384,1,-33,270,-18,-15
6385,1,11,-42,-3,14
6386,1,7,12,3,4
6387,1,-5,-36,-9,4
6388,1,4,-32,8,-4
6389,1,6,-112,14,-8
6390,1,21,20,20,1
6391,1,-11,28,-4,-7
6392,1,10,0,10,0
6393,1,-9,0,-9,0
6394,1,8,-9,9,-1
6395,1,4,-12,-2,6
6396,1,-9,-36,-12,3
6397,1,-34,280,-20,-14
6398,1,-3,-180,12,-15
6399,1,21,104,13,8
6400,1,31,220,11,20
6401,1,26,133,7,19
6402,1,16,60,10,6
6403,1,-7,-44,-11,4
6404,1,-3,-180,12,-15
6405,1,-12,-108,-18,6
6406,1,0,-49,7,-7
6407,1,-19,-20,1,-20
6408,1,14,24,12,2
6409,1,-11,10,-1,-10
6410,1,23,90,5,18
6411,1,14,-95,19,-5
6412,1,9,-52,13,-4
6413,1,13,40,8,5
6414,1,-33,272,-16,-17
6415,1,8,-48,12,-4
6416,1,0,-100,-10,10
6417,1,-18,-40,-20,2
6418,1,-25,136,-17,-8
6419,1,23,60,20,3
6420,1,-3,-108,9,-12
6421,1,-6,-160,10,-16
6422,1,-14,33,-3,-11
6423,1,-8,-20,-10,2
6424,1,-12,36,-6,-6
6425,1,-20,36,-18,-2
6426,1,36,323,17,19
6427,1,21,20,1,20
6428,1,-4,-320,-20,16
6429,1,23,60,3,20
6430,1,-20,36,-2,-18
6431,1,-20,99,-9,-11
6432,1,13,-90,18,-5
6433,1,9,-190,19,-10
6434,1,27,182,13,14
6435,1,1,0,1,0
6436,1,10,-171,-9,19
6437,1,-6,8,-4,-2
6438,1,-19,48,-16,-3
6439,1,10,-24,12,-2
6440,1,0,0,0,0
6441,1,-19,34,-17,-2
6442,1,5,-104,13,-8
6443,1,22,85,17,5
6444,1,-32,252,-14,-18
6445,1,7,-98,-7,14
6446,1,7,-228,-12,19
6447,1,-2,-15,3,-5
6448,1,0,-361,-19,19
6449,1,8,7,1,7
6450,1,9,-52,13,-4
6451,1,-4,3,-1,-3
6452,1,-18,65,-5,-13
6453,1,-22,85,-5,-17
6454,1,-14,-72,4,-18
6455,1,-10,-75,5,-15
6456,1,36,320,16,20
6457,1,-6,-7,-7,1
6458,1,10,-119,-7,17
6459,1,20,84,14,6
6460,1,1,-380,20,-19
6461,1,-18,72,-12,-6
6462,1,10,-171,-9,19
6463,1,8,-153,17,-9
6464,1,3,-40,-5,8
6465,1,-5,-150,-15,10
6466,1,-8,-9,-9,1
6467,1,-12,-13,-13,1
6468,1,13,-14,-1,14
6469,1,-12,-64,4,-16
6470,1,19,34,17,2
6471,1,-29,210,-14,-15
6472,1,5,-150,15,-10
6473,1,2,-168,-12,14
6474,1,-1,-132,11,-12
6475,1,8,-20,10,-2
6476,1,-33,270,-15,-18
6477,1,-4,-60,-10,6
6478,1,-26,160,-10,-16
6479,1,-29,198,-11,-18
6480,1,13,12,12,1
6481,1,-18,-40,-20,2
6482,1,-17,60,-5,-12
6483,1,2,-48,-6,8
6484,1,5,-150,-10,15
6485,1,-7,-228,-19,12
6486,1,-4,-96,-12,8
6487,1,5,-24,-3,8
6488,1,-15,-16,-16,1
6489,1,-4,-21,3,-7
6490,1,-9,-52,-13,4
6491,1,10,-24,12,-2
6492,1,-18,32,-16,-2
6493,1,-17,42,-14,-3
6494,1,-5,4,-4,-1
6495,1,-9,20,-5,-4
6496,1,-24,95,-5,-19
6497,1,1,-306,18,-17
6498,1,27,180,12,15
6499,1,1,-210,-14,15
6500,1,-14,0,0,-14
6501,1,16,63,9,7
6502,1,4,-5,5,-1
6503,1,-3,-54,6,-9
6504,1,-1,-182,13,-14
6505,1,23,126,14,9
6506,1,-8,-20,2,-10
6507,1,19,88,8,11
6508,1,6,-91,13,-7
6509,1,27,180,12,15
6510,1,-24,143,-13,-11
6511,1,-20,96,-8,-12
6512,1,-13,42,-6,-7
6513,1,20,36,18,2
6514,1,-17,0,-17,0
6515,1,27,176,11,16
6516,1,-18,56,-4,-14
6517,1,-26,168,-14,-12
6518,1,-20,64,-4,-16
6519,1,26,160,16,10
6520,1,-9,-10,-10,1
6521,1,-2,-288,-18,16
6522,1,4,-320,-16,20
6523,1,7,-228,-12,19
6524,1,7,-98,-7,14
6525,1,-16,48,-12,-4
6526,1,-24,95,-5,-19
6527,1,18,-40,20,-2
6528,1,-16,55,-5,-11
6529,1,-26,144,-18,-8
6530,1,11,18,2,9
6531,1,29,210,15,14
6532,1,-30,216,-12,-18
6533,1,-8,-33,3,-11
6534,1,1,-132,12,-11
6535,1,18,72,12,6
6536,1,-2,0,0,-2
6537,1,11,-102,17,-6
6538,1,-29,208,-13,-16
6539,1,21,98,14,7
6540,1,-13,-114,-19,6
6541,1,26,153,9,17
6542,1,-11,-180,9,-20
6543,1,-10,-56,4,-14
6544,1,-9,-90,-15,6
6545,1,28,192,16,12
6546,1,-10,-24,-12,2
6547,1,8,-128,16,-8
6548,1,-18,17,-1,-17
6549,1,1,-56,-7,8
6550,1,33,272,17,16
6551,1,10,-96,-6,16
6552,1,11,28,7,4
6553,1,19,48,16,3
6554,1,-12,27,-3,-9
6555,1,-5,-150,-15,10
6556,1,15,-54,-3,18
6557,1,18,0,0,18
6558,1,24,135,15,9
6559,1,5,6,3,2
6560,1,-15,-16,-16,1
6561,1,-1,-2,1,-2
6562,1,2,-15,-3,5
6563,1,22,105,15,7
6564,1,5,-126,14,-9
6565,1,-21,38,-2,-19
6566,1,-22,117,-9,-13
6567,1,2,0,0,2
6568,1,-35,300,-15,-20
6569,1,11,10,1,10
6570,1,23,130,13,10
6571,1,12,-133,-7,19
6572,1,-12,20,-2,-10
6573,1,-8,-84,6,-14
6574,1,-19,60,-15,-4
6575,1,5,6,2,3
6576,1,32,252,14,18
6577,1,-26,169,-13,-13
6578,1,-13,0,-13,0
6579,1,21,80,16,5
6580,1,19,18,1,18
6581,1,6,-16,-2,8
6582,1,12,-160,20,-8
6583,1,-30,224,-14,-16
6584,1,-12,-45,-15,3
6585,1,12,35,5,7
6586,1,-1,-72,-9,8
6587,1,4,-192,16,-12
6588,1,11,24,3,8
6589,1,-2,-288,16,-18
6590,1,14,-15,-1,15
6591,1,-25,100,-20,-5
6592,1,-14,49,-7,-7
6593,1,1,-156,13,-12
6594,1,13,30,3,10
6595,1,24,143,11,13
6596,1,-13,22,-2,-11
6597,1,-5,-126,-14,9
6598,1,-31,228,-12,-19
6599,1,7,-260,20,-13
6600,1,13,-90,-5,18
6601,1,28,196,14,14
6602,1,16,63,7,9
6603,1,-3,-270,15,-18
6604,1,12,-85,-5,17
6605,1,-16,-57,3,-19
6606,1,-24,119,-7,-17
6607,1,35,300,20,15
6608,1,-4,-21,3,-7
6609,1,5,-66,11,-6
6610,1,-23,90,-5,-18
6611,1,14,-120,20,-6
6612,1,-6,-135,-15,9
6613,1,-3,-340,-20,17
6614,1,-20,36,-18,-2
6615,1,30,221,13,17
6616,1,21,108,12,9
6617,1,-2,-288,16,-18
6618,1,-8,-65,5,-13
6619,1,0,-49,7,-7
6620,1,-31,220,-11,-20
6621,1,-2,-48,6,-8
6622,1,33,270,18,15
6623,1,-1,-42,6,-7
6624,1,15,44,11,4
6625,1,-24,80,-4,-20
6626,1,25,100,20,5
6627,1,2,-168,-12,14
6628,1,2,-35,-5,7
6629,1,4,-252,18,-14
6630,1,18,0,18,0
6631,1,-30,216,-18,-12
6632,1,22,40,2,20
6633,1,-1,-132,-12,11
6634,1,-29,198,-18,-11
6635,1,-6,-27,3,-9
6636,1,25,154,11,14
6637,1,16,-57,-3,19
6638,1,-2,-80,-10,8
6639,1,-2,-35,5,-7
6640,1,-25,126,-7,-18
6641,1,2,-48,-6,8
6642,1,-1,-132,11,-12
6643,1,-21,108,-12,-9
6644,1,-11,-42,-14,3
6645,1,18,32,16,2
6646,1,7,-30,10,-3
6647,1,-16,-80,4,-20
6648,1,5,-84,12,-7
6649,1,-17,66,-11,-6
6650,1,-14,40,-4,-10
6651,1,1,-380,-19,20
6652,1,-10,9,-1,-9
6653,1,-9,18,-3,-6
6654,1,-13,-90,-18,5
6655,1,4,-12,6,-2
6656,1,-12,-85,-17,5
6657,1,-14,-51,-17,3
6658,1,-15,-100,5,-20
6659,1,3,2,1,2
6660,1,-6,8,-2,-4
6661,1,10,-24,12,-2
6662,1,-1,-240,15,-16
6663,1,-9,20,-5,-4
6664,1,16,-80,20,-4
6665,1,-26,160,-10,-16
6666,1,-20,91,-7,-13
6667,1,34,285,15,19
6668,1,-8,12,-6,-2
6669,1,-14,40,-10,-4
6670,1,-18,65,-5,-13
6671,1,7,-8,8,-1
6672,1,22,112,8,14
6673,1,14,-51,-3,17
6674,1,30,216,12,18
6675,1,-8,-128,8,-16
6676,1,-5,-204,-17,12
6677,1,30,216,12,18
6678,1,5,-266,19,-14
6679,1,16,48,4,12
6680,1,-16,60,-6,-10
6681,1,-15,56,-7,-8
6682,1,-14,24,-12,-2
6683,1,1,-342,-18,19
6684,1,5,-234,-13,18
6685,1,-3,-208,-16,13
6686,1,0,-81,-9,9
6687,1,-1,-30,5,-6
6688,1,-4,0,0,-4
6689,1,11,30,5,6
6690,1,-4,3,-3,-1
6691,1,9,8,8,1
6692,1,-6,8,-4,-2
6693,1,22,72,4,18
6694,1,-3,-54,-9,6
6695,1,-12,11,-11,-1
6696,1,24,128,16,8
6697,1,-3,0,0,-3
6698,1,-10,-24,-12,2
6699,1,-1,-72,-9,8
6700,1,4,-45,9,-5
6701,1,-37,340,-17,-20
6702,1,2,-323,-17,19
6703,1,-29,190,-19,-10
6704,1,-7,-198,11,-18
6705,1,15,14,1,14
6706,1,2,-224,-14,16
6707,1,3,-10,5,-2
6708,1,4,0,0,4
6709,1,1,-272,-16,17
6710,1,1,-12,-3,4
6711,1,-13,42,-6,-7
6712,1,5,-234,-13,18
6713,1,11,10,10,1
6714,1,-14,-120,-20,6
6715,1,-22,117,-9,-13
6716,1,4,-165,15,-11
6717,1,32,240,12,20
6718,1,31,234,13,18
6719,1,-6,-187,-17,11
6720,1,22,40,20,2
6721,1,-9,20,-4,-5
6722,1,6,-187,-11,17
6723,1,-34,280,-14,-20
6724,1,6,-160,16,-10
6725,1,38,360,18,20
6726,1,-21,90,-15,-6
6727,1,9,20,5,4
6728,1,27,152,8,19
6729,1,9,8,8,1
6730,1,-34,280,-20,-14
6731,1,-18,45,-15,-3
6732,1,5,-300,20,-15
6733,1,21,68,4,17
6734,1,32,255,17,15
6735,1,-17,66,-6,-11
6736,1,9,0,9,0
6737,1,-18,17,-1,-17
6738,1,-34,285,-15,-19
6739,1,-1,-6,2,-3
6740,1,-14,0,0,-14
6741,1,23,76,4,19
6742,1,-12,-160,-20,8
6743,1,-16,-57,3,-19
6744,1,15,-54,-3,18
6745,1,0,-169,13,-13
6746,1,6,-7,7,-1
6747,1,-11,-26,-13,2
6748,1,-15,0,-15,0
6749,1,1,-156,13,-12
6750,1,6,5,1,5
6751,1,37,342,19,18
6752,1,-26,144,-18,-8
6753,1,3,-154,-11,14
6754,1,24,128,8,16
6755,1,21,54,3,18
6756,1,-14,-32,2,-16
6757,1,21,80,16,5
6758,1,15,-16,-1,16
6759,1,-7,10,-2,-5
6760,1,4,-320,20,-16
6761,1,12,-64,-4,16
6762,1,-24,144,-12,-12
6763,1,4,-12,-2,6
6764,1,-29,180,-9,-20
6765,1,2,-120,-10,12
6766,1,-7,-120,8,-15
6767,1,-4,-252,-18,14
6768,1,10,25,5,5
6769,1,-17,72,-8,-9
6770,1,-18,77,-11,-7
6771,1,-9,14,-2,-7
6772,1,-4,-5,1,-5
6773,1,-5,6,-2,-3
6774,1,-22,112,-14,-8
6775,1,5,6,3,2
6776,1,4,-21,-3,7
6777,1,0,-289,-17,17
6778,1,8,-209,19,-11
6779,1,-23,112,-7,-16
6780,1,12,0,12,0
6781,1,-5,-126,9,-14
6782,1,-19,78,-13,-6
6783,1,22,72,18,4
6784,1,5,-14,-2,7
6785,1,-8,-180,-18,10
6786,1,-28,180,-10,-18
6787,1,5,-126,-9,14
6788,1,26,133,7,19
6789,1,-16,55,-5,-11
6790,1,-20,91,-13,-7
6791,1,25,156,13,12
6792,1,-8,-240,12,-20
6793,1,-25,144,-9,-16
6794,1,27,180,15,12
6795,1,-39,380,-19,-20
6796,1,13,42,7,6
6797,1,-6,-160,10,-16
6798,1,-2,-48,6,-8
6799,1,18,72,12,6
6800,1,-13,-48,3,-16
6801,1,-40,400,-20,-20
6802,1,-2,-195,13,-15
6803,1,27,176,11,16
6804,1,1,-132,12,-11
6805,1,-8,-65,-13,5
6806,1,9,-90,-6,15
6807,1,28,180,10,18
6808,1,4,-192,16,-12
6809,1,-27,170,-17,-10
6810,1,-20,64,-4,-16
6811,1,-5,-66,6,-11
6812,1,8,15,5,3
6813,1,-21,54,-18,-3
6814,1,-13,-90,-18,5
6815,1,-6,0,0,-6
6816,1,26,120,6,20
6817,1,-17,-38,-19,2
6818,1,9,-190,19,-10
6819,1,10,24,4,6
6820,1,29,180,9,20
6821,1,-32,252,-18,-14
6822,1,24,135,9,15
6823,1,-9,-10,1,-10
6824,1,1,-156,13,-12
6825,1,11,-126,18,-7
6826,1,4,-60,10,-6
6827,1,-18,56,-14,-4
6828,1,-5,6,-2,-3
6829,1,7,-18,-2,9
6830,1,0,-25,5,-5
6831,1,13,-30,-2,15
6832,1,10,-24,12,-2
6833,1,-6,-187,11,-17
6834,1,2,-80,-8,10
6835,1,-21,110,-10,-11
6836,1,-4,-5,1,-5
6837,1,-21,20,-1,-20
6838,1,1,-342,-18,19
6839,1,15,-76,19,-4
6840,1,13,-48,16,-3
6841,1,-9,-22,2,-11
6842,1,6,-160,-10,16
6843,1,3,-270,18,-15
6844,1,14,0,14,0
6845,1,-7,-44,-11,4
6846,1,0,-144,-12,12
6847,1,0,-225,-15,15
6848,1,16,-36,-2,18
6849,1,-12,11,-11,-1
6850,1,27,170,10,17
6851,1,24,143,11,13
6852,1,16,15,1,15
6853,1,2,-3,3,-1
6854,1,-23,130,-10,-13
6855,1,5,0,5,0
6856,1,17,66,6,11
6857,1,32,240,12,20
6858,1,-17,66,-11,-6
6859,1,-12,-28,-14,2
6860,1,22,40,2,20
6861,1,-21,20,-1,-20
6862,1,3,-10,-2,5
6863,1,-13,36,-9,-4
6864,1,-24,119,-17,-7
6865,1,7,-18,-2,9
6866,1,18,-19,-1,19
6867,1,1,0,0,1
6868,1,4,-5,5,-1
6869,1,12,35,7,5
6870,1,-5,-14,2,-7
6871,1,-14,-95,5,-19
6872,1,13,-90,-5,18
6873,1,8,-209,-11,19
6874,1,9,18,3,6
6875,1,-13,-14,-14,1
6876,1,-3,2,-1,-2
6877,1,-9,0,-9,0
6878,1,-13,-68,4,-17
6879,1,5,-104,-8,13
6880,1,40,400,20,20
6881,1,35,300,20,15
6882,1,-1,-42,6,-7
6883,1,-10,-96,6,-16
6884,1,32,240,12,20
6885,1,-27,162,-9,-18
6886,1,13,30,3,10
6887,1,-25,114,-6,-19
6888,1,11,-12,-1,12
6889,1,-10,-171,-19,9
6890,1,-16,15,-15,-1
6891,1,-14,-15,1,-15
6892,1,0,-225,15,-15
6893,1,-15,-100,5,-20
6894,1,26,120,20,6
6895,1,13,-14,-1,14
6896,1,-32,247,-19,-13
6897,1,18,65,13,5
6898,1,6,-216,18,-12
6899,1,2,-323,19,-17
6900,1,15,26,13,2
6901,1,-31,228,-12,-19
6902,1,4,-32,8,-4
6903,1,22,40,2,20
6904,1,-16,15,-15,-1
6905,1,-13,22,-2,-11
6906,1,-9,-190,-19,10
6907,1,-16,28,-2,-14
6908,1,-12,35,-7,-5
6909,1,-5,-176,-16,11
6910,1,-18,45,-3,-15
6911,1,24,140,14,10
6912,1,-16,-80,-20,4
6913,1,-36,320,-16,-20
6914,1,4,-285,19,-15
6915,1,34,288,18,16
6916,1,13,12,1,12
6917,1,-20,64,-4,-16
6918,1,24,80,20,4
6919,1,-22,72,-18,-4
6920,1,-14,-51,-17,3
6921,1,-15,-100,-20,5
6922,1,3,-130,13,-10
6923,1,6,-280,-14,20
6924,1,-36,323,-19,-17
6925,1,-5,4,-4,-1
6926,1,2,-224,-14,16
6927,1,18,72,12,6
6928,1,7,-78,13,-6
6929,1,7,10,5,2
6930,1,-15,54,-9,-6
6931,1,29,198,11,18
6932,1,27,162,18,9
6933,1,-21,54,-18,-3
6934,1,18,65,5,13
6935,1,35,300,20,15
6936,1,-12,-28,-14,2
6937,1,11,28,4,7
6938,1,-23,60,-20,-3
6939,1,18,-40,-2,20
6940,1,-26,133,-7,-19
6941,1,-9,-22,-11,2
6942,1,25,100,20,5
6943,1,14,49,7,7
6944,1,9,-220,-11,20
6945,1,-37,342,-18,-19
6946,1,-6,5,-5,-1
6947,1,28,187,17,11
6948,1,7,-98,-7,14
6949,1,-10,9,-9,-1
6950,1,-3,2,-1,-2
6951,1,12,-85,-5,17
6952,1,-6,8,-4,-2
6953,1,11,18,2,9
6954,1,-15,-16,1,-16
6955,1,-18,65,-5,-13
6956,1,-17,16,-16,-1
6957,1,16,28,2,14
6958,1,21,80,16,5
6959,1,2,1,1,1
6960,1,-5,4,-4,-1
6961,1,15,-16,16,-1
6962,1,7,-260,20,-13
6963,1,6,-55,11,-5
6964,1,10,-144,-8,18
6965,1,39,380,19,20
6966,1,-32,240,-20,-12
6967,1,-11,18,-9,-2
6968,1,-33,260,-20,-13
6969,1,30,221,13,17
6970,1,6,-280,20,-14
6971,1,26,168,12,14
6972,1,-19,88,-8,-11
6973,1,9,-220,-11,20
6974,1,22,120,10,12
6975,1,17,30,15,2
6976,1,19,48,3,16
6977,1,-21,104,-8,-13
6978,1,-16,-57,-19,3
6979,1,7,-120,15,-8
6980,1,32,255,17,15
6981,1,10,21,3,7
6982,1,-3,-108,-12,9
6983,1,19,48,16,3
6984,1,-13,-30,-15,2
6985,1,-20,64,-4,-16
6986,1,7,-120,15,-8
6987,1,3,-4,4,-1
6988,1,-2,-35,5,-7
6989,1,-5,-126,-14,9
6990,1,10,-56,-4,14
6991,1,12,-108,-6,18
6992,1,-32,240,-12,-20
6993,1,-22,112,-8,-14
6994,1,-10,-119,-17,7
6995,1,-3,0,0,-3
6996,1,-6,5,-5,-1
6997,1,5,-36,-4,9
6998,1,0,-9,-3,3
6999,1,15,36,12,3
7000,1,-18,80,-8,-10
7001,1,19,78,6,13
7002,1,-13,30,-10,-3
7003,1,-2,-195,-15,13
7004,1,-4,-285,15,-19
7005,1,-6,-112,-14,8
7006,1,-24,128,-8,-16
7007,1,24,140,14,10
7008,1,12,36,6,6
7009,1,-13,-48,-16,3
7010,1,26,160,16,10
7011,1,-10,-144,-18,8
7012,1,-5,-36,-9,4
7013,1,23,130,13,10
7014,1,2,-63,9,-7
7015,1,-16,63,-7,-9
7016,1,5,-6,-1,6
7017,1,13,-140,20,-7
7018,1,-19,-20,1,-20
7019,1,-9,-10,-10,1
7020,1,-2,-99,-11,9
7021,1,17,30,15,2
7022,1,14,40,10,4
7023,1,-11,-26,-13,2
7024,1,6,-91,-7,13
7025,1,16,-80,20,-4
7026,1,-1,-42,6,-7
7027,1,16,0,16,0
7028,1,-2,-195,13,-15
7029,1,26,153,9,17
7030,1,25,144,16,9
7031,1,-5,-266,14,-19
7032,1,-14,24,-2,-12
7033,1,7,-18,-2,9
7034,1,-5,-6,-6,1
7035,1,14,-15,15,-1
7036,1,23,102,17,6
7037,1,-9,-136,8,-17
7038,1,27,182,13,14
7039,1,-30,216,-18,-12
7040,1,-13,-90,5,-18
7041,1,2,-3,-1,3
7042,1,0,-4,2,-2
7043,1,3,-130,-10,13
7044,1,0,-9,3,-3
7045,1,12,11,11,1
7046,1,29,208,13,16
7047,1,-1,-30,5,-6
7048,1,-12,11,-11,-1
7049,1,13,-114,-6,19
7050,1,-27,140,-20,-7
7051,1,37,340,20,17
7052,1,-13,30,-10,-3
7053,1,26,165,11,15
7054,1,-5,-36,4,-9
7055,1,23,130,13,10
7056,1,-12,11,-11,-1
7057,1,-29,204,-12,-17
7058,1,-16,-17,-17,1
7059,1,5,-84,-7,12
7060,1,-14,-120,6,-20
7061,1,12,-160,-8,20
7062,1,17,52,13,4
7063,1,7,0,0,7
7064,1,-30,216,-18,-12
7065,1,-34,288,-16,-18
7066,1,-13,30,-3,-10
7067,1,-6,-91,7,-13
7068,1,-19,60,-15,-4
7069,1,8,-209,-11,19
7070,1,1,-56,8,-7
7071,1,6,-91,13,-7
7072,1,-16,-57,3,-19
7073,1,-9,-90,-15,6
7074,1,29,204,12,17
7075,1,15,36,12,3
7076,1,-3,-208,-16,13
7077,1,-25,136,-17,-8
7078,1,-9,-52,4,-13
7079,1,16,55,5,11
7080,1,-15,56,-7,-8
7081,1,6,-72,-6,12
7082,1,37,340,17,20
7083,1,-11,-126,-18,7
7084,1,21,90,6,15
7085,1,-16,-80,4,-20
7086,1,-4,-320,-20,16
7087,1,0,-324,-18,18
7088,1,26,168,12,14
7089,1,0,-64,8,-8
7090,1,-12,-85,-17,5
7091,1,28,192,12,16
7092,1,11,-26,-2,13
7093,1,-7,12,-4,-3
7094,1,27,140,20,7
7095,1,18,65,5,13
7096,1,-3,-108,-12,9
7097,1,19,60,15,4
7098,1,21,108,12,9
7099,1,-34,285,-19,-15
7100,1,28,196,14,14
7101,1,-39,380,-19,-20
7102,1,27,182,14,13
7103,1,-4,-32,4,-8
7104,1,-6,-91,7,-13
7105,1,15,14,14,1
7106,1,2,-99,11,-9
7107,1,9,-90,-6,15
7108,1,21,80,16,5
7109,1,12,-85,17,-5
7110,1,23,90,5,18
7111,1,1,-306,18,-17
7112,1,0,-196,14,-14
7113,1,6,-216,-12,18
7114,1,-18,65,-13,-5
7115,1,-21,98,-14,-7
7116,1,16,39,13,3
7117,1,15,44,11,4
7118,1,-5,-300,15,-20
7119,1,2,-8,-2,4
7120,1,-25,100,-20,-5
7121,1,8,-84,-6,14
7122,1,38,361,19,19
7123,1,10,-24,-2,12
7124,1,15,-76,-4,19
7125,1,6,0,0,6
7126,1,24,135,9,15
7127,1,13,-140,20,-7
7128,1,-11,-12,-12,1
7129,1,-15,26,-13,-2
7130,1,6,-160,-10,16
7131,1,-17,16,-1,-16
7132,1,3,-70,-7,10
7133,1,-35,306,-17,-18
7134,1,-7,6,-6,-1
7135,1,6,-40,10,-4
7136,1,-9,-22,2,-11
7137,1,-22,85,-17,-5
7138,1,22,40,2,20
7139,1,-33,272,-17,-16
7140,1,7,-30,10,-3
7141,1,21,104,13,8
7142,1,-1,-380,-20,19
7143,1,-14,24,-2,-12
7144,1,-5,0,-5,0
7145,1,-23,60,-20,-3
7146,1,-17,0,-17,0
7147,1,-18,-19,1,-19
7148,1,9,-10,10,-1
7149,1,13,-90,-5,18
7150,1,-11,-102,-17,6
7151,1,11,-180,20,-9
7152,1,-11,-60,4,-15
7153,1,21,104,13,8
7154,1,-14,-95,5,-19
7155,1,-33,270,-15,-18
7156,1,21,80,5,16
7157,1,14,-95,19,-5
7158,1,-6,-187,11,-17
7159,1,-13,-90,5,-18
7160,1,30,209,19,11
7161,1,12,-108,-6,18
7162,1,-14,33,-3,-11
7163,1,-12,-28,-14,2
7164,1,-4,-60,-10,6
7165,1,-1,-306,-18,17
7166,1,29,198,11,18
7167,1,-16,64,-8,-8
7168,1,-4,-165,-15,11
7169,1,12,20,10,2
7170,1,-29,180,-20,-9
7171,1,-9,0,-9,0
7172,1,-8,-240,12,-20
7173,1,-20,64,-4,-16
7174,1,-17,-18,-18,1
7175,1,-5,6,-3,-2
7176,1,28,195,13,15
7177,1,-11,-102,6,-17
7178,1,10,-119,17,-7
7179,1,-17,60,-12,-5
7180,1,-22,112,-14,-8
7181,1,-1,-380,-20,19
7182,1,4,-45,-5,9
7183,1,2,-15,-3,5
7184,1,-4,-5,1,-5
7185,1,6,-112,14,-8
7186,1,4,-21,-3,7
7187,1,13,-114,19,-6
7188,1,-31,220,-20,-11
7189,1,-9,8,-8,-1
7190,1,0,-400,20,-20
7191,1,-9,20,-4,-5
7192,1,9,-70,-5,14
7193,1,-31,238,-17,-14
7194,1,-11,-152,-19,8
7195,1,-10,-171,9,-19
7196,1,14,-32,16,-2
7197,1,-7,-198,11,-18
7198,1,13,-114,19,-6
7199,1,20,19,1,19
7200,1,-21,38,-2,-19
7201,1,6,9,3,3
7202,1,-22,40,-20,-2
7203,1,5,-126,-9,14
7204,1,7,-60,-5,12
7205,1,10,16,8,2
7206,1,29,210,14,15
7207,1,-16,-80,-20,4
7208,1,-7,-18,2,-9
7209,1,2,-288,18,-16
7210,1,13,36,9,4
7211,1,4,-5,5,-1
7212,1,-36,320,-20,-16
7213,1,35,306,17,18
7214,1,11,30,6,5
7215,1,-6,-55,-11,5
7216,1,16,48,4,12
7217,1,-20,100,-10,-10
7218,1,-3,-108,9,-12
7219,1,-16,-17,1,-17
7220,1,36,320,16,20
7221,1,0,-169,-13,13
7222,1,20,51,3,17
7223,1,-9,18,-3,-6
7224,1,4,-5,5,-1
7225,1,-12,-160,8,-20
7226,1,15,54,9,6
7227,1,-21,98,-14,-7
7228,1,0,-4,2,-2
7229,1,-4,-5,1,-5
7230,1,8,15,3,5
7231,1,-18,80,-8,-10
7232,1,15,26,2,13
7233,1,17,70,10,7
7234,1,-12,-85,-17,5
7235,1,18,81,9,9
7236,1,-12,-28,2,-14
7237,1,21,54,3,18
7238,1,13,-90,-5,18
7239,1,5,-234,-13,18
7240,1,-12,27,-3,-9
7241,1,-32,240,-20,-12
7242,1,16,48,12,4
7243,1,-35,306,-17,-18
7244,1,-21,80,-16,-5
7245,1,2,-48,8,-6
7246,1,2,-224,16,-14
7247,1,-21,98,-7,-14
7248,1,0,-144,12,-12
7249,1,11,28,7,4
7250,1,-15,54,-9,-6
7251,1,-3,-10,-5,2
7252,1,-34,280,-20,-14
7253,1,19,70,5,14
7254,1,25,150,10,15
7255,1,8,-209,19,-11
7256,1,-2,-120,10,-12
7257,1,-5,-126,-14,9
7258,1,-10,0,-10,0
7259,1,12,-45,-3,15
7260,1,-15,36,-12,-3
7261,1,-1,-110,-11,10
7262,1,-17,-38,-19,2
7263,1,2,-8,-2,4
7264,1,10,-56,-4,14
7265,1,-25,126,-18,-7
7266,1,-8,12,-6,-2
7267,1,29,190,10,19
7268,1,-5,-24,3,-8
7269,1,14,24,2,12
7270,1,-4,-320,16,-20
7271,1,-7,-78,-13,6
7272,1,-30,200,-20,-10
7273,1,-11,-26,2,-13
7274,1,-2,-48,-8,6
7275,1,12,-85,-5,17
7276,1,-15,-54,3,-18
7277,1,7,-120,15,-8
7278,1,2,-360,-18,20
7279,1,-34,280,-14,-20
7280,1,-2,-360,18,-20
7281,1,4,-32,-4,8
7282,1,27,180,12,15
7283,1,9,-36,12,-3
7284,1,24,140,10,14
7285,1,20,19,19,1
7286,1,6,-72,-6,12
7287,1,-22,72,-18,-4
7288,1,-5,-204,-17,12
7289,1,-10,-96,6,-16
7290,1,-1,-380,19,-20
7291,1,-5,-84,7,-12
7292,1,-18,72,-12,-6
7293,1,34,288,18,16
7294,1,-29,198,-11,-18
7295,1,-17,42,-14,-3
7296,1,-17,72,-8,-9
7297,1,-20,84,-6,-14
7298,1,9,18,6,3
7299,1,6,-27,-3,9
7300,1,-1,-42,6,-7
7301,1,17,-18,18,-1
7302,1,-31,240,-15,-16
7303,1,6,-135,15,-9
7304,1,-9,0,-9,0
7305,1,-30,200,-10,-20
7306,1,-23,90,-18,-5
7307,1,-3,2,-2,-1
7308,1,-11,-126,7,-18
7309,1,1,0,0,1
7310,1,-15,-34,2,-17
7311,1,-6,8,-2,-4
7312,1,-27,176,-11,-16
7313,1,3,-40,8,-5
7314,1,-12,20,-10,-2
7315,1,12,20,10,2
7316,1,28,160,8,20
7317,1,22,40,20,2
7318,1,-26,165,-15,-11
7319,1,-5,-36,-9,4
7320,1,6,-72,-6,12
7321,1,-12,11,-11,-1
7322,1,23,60,20,3
7323,1,21,104,8,13
7324,1,-9,-10,-10,1
7325,1,-2,-168,-14,12
7326,1,3,-154,14,-11
7327,1,5,-204,-12,17
7328,1,-24,128,-8,-16
7329,1,32,240,12,20
7330,1,-8,12,-2,-6
7331,1,-4,-96,8,-12
7332,1,-7,10,-2,-5
7333,1,-20,96,-8,-12
7334,1,-10,16,-2,-8
7335,1,-5,0,0,-5
7336,1,3,-40,8,-5
7337,1,-16,63,-9,-7
7338,1,-1,-306,17,-18
7339,1,-7,12,-4,-3
7340,1,-2,0,-2,0
7341,1,-14,48,-6,-8
7342,1,0,-9,3,-3
7343,1,20,96,12,8
7344,1,12,0,12,0
7345,1,-23,132,-11,-12
7346,1,-27,176,-11,-16
7347,1,4,-165,-11,15
7348,1,-1,-306,17,-18
7349,1,-3,-270,15,-18
7350,1,29,180,9,20
7351,1,-14,40,-4,-10
7352,1,17,30,2,15
7353,1,-4,-285,15,-19
7354,1,-28,187,-17,-11
7355,1,-7,0,-7,0
7356,1,-23,102,-6,-17
7357,1,-31,228,-12,-19
7358,1,0,-36,-6,6
7359,1,4,-221,17,-13
7360,1,-20,36,-18,-2
7361,1,28,187,11,17
7362,1,2,-360,-18,20
7363,1,-1,-6,2,-3
7364,1,-7,6,-1,-6
7365,1,-6,-160,10,-16
7366,1,11,10,10,1
7367,1,-8,-180,10,-18
7368,1,-17,52,-4,-13
7369,1,-2,-99,9,-11
7370,1,2,-168,-12,14
7371,1,-24,95,-19,-5
7372,1,11,0,0,11
7373,1,15,50,5,10
7374,1,-7,12,-3,-4
7375,1,13,0,13,0
7376,1,-2,-24,-6,4
7377,1,4,3,1,3
7378,1,-20,96,-12,-8
7379,1,13,36,9,4
7380,1,-30,209,-19,-11
7381,1,-6,-16,2,-8
7382,1,17,16,16,1
7383,1,-24,108,-18,-6
7384,1,16,63,7,9
7385,1,9,-162,-9,18
7386,1,26,160,16,10
7387,1,-10,-144,8,-18
7388,1,31,228,12,19
7389,1,14,-72,-4,18
7390,1,1,-42,-6,7
7391,1,8,16,4,4
7392,1,-15,14,-14,-1
7393,1,-26,120,-20,-6
7394,1,3,-54,-6,9
7395,1,-26,160,-10,-16
7396,1,-14,-32,-16,2
7397,1,-19,88,-8,-11
7398,1,38,361,19,19
7399,1,-6,-187,-17,11
7400,1,-3,2,-2,-1
7401,1,-22,117,-13,-9
7402,1,7,-198,-11,18
7403,1,-3,-270,15,-18
7404,1,13,0,13,0
7405,1,5,-50,10,-5
7406,1,4,-221,-13,17
7407,1,-9,18,-3,-6
7408,1,-20,84,-6,-14
7409,1,8,-153,17,-9
7410,1,13,-90,-5,18
7411,1,-7,-120,-15,8
7412,1,-38,360,-20,-18
7413,1,3,-130,13,-10
7414,1,-18,81,-9,-9
7415,1,-10,-200,-20,10
7416,1,-26,165,-11,-15
7417,1,-22,85,-5,-17
7418,1,11,-102,17,-6
7419,1,-30,225,-15,-15
7420,1,-4,-5,-5,1
7421,1,-16,-36,2,-18
7422,1,30,225,15,15
7423,1,-27,152,-8,-19
7424,1,11,28,7,4
7425,1,-20,96,-12,-8
7426,1,39,380,20,19
7427,1,-25,126,-7,-18
7428,1,-8,-20,2,-10
7429,1,-14,24,-12,-2
7430,1,5,-50,-5,10
7431,1,-14,24,-2,-12
7432,1,-9,-90,-15,6
7433,1,-1,-272,16,-17
7434,1,-21,20,-1,-20
7435,1,4,0,4,0
7436,1,-13,-30,-15,2
7437,1,-4,-77,-11,7
7438,1,-22,72,-18,-4
7439,1,-19,34,-2,-17
7440,1,2,-143,-11,13
7441,1,-11,-152,8,-19
7442,1,-6,-160,-16,10
7443,1,-18,65,-13,-5
7444,1,1,-6,-2,3
7445,1,2,-63,9,-7
7446,1,-7,-144,9,-16
7447,1,-2,-224,-16,14
7448,1,-35,304,-19,-16
7449,1,21,108,12,9
7450,1,35,306,18,17
7451,1,3,-130,13,-10
7452,1,20,64,16,4
7453,1,10,-171,19,-9
7454,1,6,-112,-8,14
7455,1,-1,-12,3,-4
7456,1,-6,-7,1,-7
7457,1,0,-225,-15,15
7458,1,14,33,11,3
7459,1,2,-48,8,-6
7460,1,37,340,20,17
7461,1,-5,-66,6,-11
7462,1,-32,255,-17,-15
7463,1,22,72,18,4
7464,1,27,140,20,7
7465,1,1,-30,-5,6
7466,1,-22,105,-15,-7
7467,1,0,-324,18,-18
7468,1,15,-54,-3,18
7469,1,-1,-272,16,-17
7470,1,19,48,3,16
7471,1,6,-16,8,-2
7472,1,-5,-36,-9,4
7473,1,-12,-133,7,-19
7474,1,-10,-75,5,-15
7475,1,-27,170,-17,-10
7476,1,17,0,17,0
7477,1,4,-165,-11,15
7478,1,-22,117,-13,-9
7479,1,4,-5,-1,5
7480,1,16,-36,-2,18
7481,1,2,-288,18,-16
7482,1,-13,-90,5,-18
7483,1,27,176,16,11
7484,1,19,34,17,2
7485,1,-1,-132,-12,11
7486,1,-18,80,-10,-8
7487,1,20,51,17,3
7488,1,14,-95,-5,19
7489,1,5,-176,16,-11
7490,1,12,0,0,12
7491,1,6,-55,-5,11
7492,1,-33,272,-16,-17
7493,1,7,-120,15,-8
7494,1,17,66,11,6
7495,1,-31,234,-18,-13
7496,1,10,-56,14,-4
7497,1,5,-126,14,-9
7498,1,2,-80,10,-8
7499,1,-1,-156,12,-13
7500,1,-9,-70,5,-14
7501,1,4,-252,-14,18
7502,1,1,0,0,1
7503,1,-30,216,-18,-12
7504,1,3,-108,-9,12
7505,1,17,72,8,9
7506,1,24,135,9,15
7507,1,14,48,6,8
7508,1,-14,-51,3,-17
7509,1,24,95,19,5
7510,1,-24,108,-18,-6
7511,1,-2,-143,11,-13
7512,1,-23,126,-9,-14
7513,1,31,228,12,19
7514,1,12,0,12,0
7515,1,1,-30,-5,6
7516,1,33,266,19,14
7517,1,30,225,15,15
7518,1,7,-8,8,-1
7519,1,22,72,4,18
7520,1,-17,70,-10,-7
7521,1,-8,-65,-13,5
7522,1,-4,-12,2,-6
7523,1,8,-240,20,-12
7524,1,-10,-200,-20,10
7525,1,-28,192,-12,-16
7526,1,-2,-63,7,-9
7527,1,-8,7,-1,-7
7528,1,2,-168,14,-12
7529,1,6,5,1,5
7530,1,19,70,5,14
7531,1,-18,80,-10,-8
7532,1,-26,120,-6,-20
7533,1,-5,-84,-12,7
7534,1,-32,240,-12,-20
7535,1,-7,6,-6,-1
7536,1,5,-50,10,-5
7537,1,-6,-187,11,-17
7538,1,16,-80,-4,20
7539,1,7,-170,17,-10
7540,1,7,-120,15,-8
7541,1,9,20,5,4
7542,1,25,114,19,6
7543,1,31,238,17,14
7544,1,7,12,3,4
7545,1,-8,-128,-16,8
7546,1,19,18,18,1
7547,1,3,-40,-5,8
7548,1,24,108,6,18
7549,1,-12,0,0,-12
7550,1,-3,-88,8,-11
7551,1,9,20,4,5
7552,1,6,-7,-1,7
7553,1,1,-306,-17,18
7554,1,10,-39,13,-3
7555,1,2,-80,-8,10
7556,1,11,-152,-8,19
7557,1,4,-140,-10,14
7558,1,-22,112,-8,-14
7559,1,-15,54,-9,-6
7560,1,-3,-270,-18,15
7561,1,-18,0,-18,0
7562,1,-24,80,-20,-4
7563,1,29,210,14,15
7564,1,2,-15,-3,5
7565,1,3,-238,-14,17
7566,1,-5,-36,4,-9
7567,1,0,0,0,0
7568,1,11,-126,-7,18
7569,1,7,-44,-4,11
7570,1,24,108,18,6
7571,1,-11,-152,8,-19
7572,1,9,-90,15,-6
7573,1,-3,-28,-7,4
7574,1,6,-72,12,-6
7575,1,23,76,4,19
7576,1,-7,-30,-10,3
7577,1,-11,-152,8,-19
7578,1,13,-114,19,-6
7579,1,-4,-320,16,-20
7580,1,-26,168,-14,-12
7581,1,-1,0,-1,0
7582,1,19,0,0,19
7583,1,8,-65,-5,13
7584,1,-4,-77,-11,7
7585,1,23,120,8,15
7586,1,-2,-360,-20,18
7587,1,-4,-77,-11,7
7588,1,0,-121,-11,11
7589,1,11,0,11,0
7590,1,17,-38,19,-2
7591,1,-2,-8,-4,2
7592,1,18,65,13,5
7593,1,-24,128,-8,-16
7594,1,8,16,4,4
7595,1,-16,55,-5,-11
7596,1,5,4,4,1
7597,1,4,-165,15,-11
7598,1,11,-60,15,-4
7599,1,5,-6,-1,6
7600,1,-20,0,0,-20
7601,1,18,65,5,13
7602,1,-32,252,-18,-14
7603,1,21,54,3,18
7604,1,9,20,5,4
7605,1,-35,300,-15,-20
7606,1,7,-60,-5,12
7607,1,14,-15,-1,15
7608,1,3,-70,10,-7
7609,1,-31,234,-13,-18
7610,1,-25,150,-15,-10
7611,1,-2,-120,10,-12
7612,1,-7,-8,-8,1
7613,1,4,-252,18,-14
7614,1,-2,-288,16,-18
7615,1,-38,361,-19,-19
7616,1,7,-30,-3,10
7617,1,12,-85,17,-5
7618,1,20,84,6,14
7619,1,27,180,12,15
7620,1,1,-30,-5,6
7621,1,-11,-180,-20,9
7622,1,10,-96,-6,16
7623,1,-26,120,-6,-20
7624,1,11,-60,15,-4
7625,1,15,-16,16,-1
7626,1,-12,11,-11,-1
7627,1,-8,-240,12,-20
7628,1,-4,-285,-19,15
7629,1,-24,135,-9,-15
7630,1,-15,26,-2,-13
7631,1,6,-55,11,-5
7632,1,-29,210,-14,-15
7633,1,18,0,18,0
7634,1,-25,156,-12,-13
7635,1,-26,153,-9,-17
7636,1,2,-360,-18,20
7637,1,5,-300,-15,20
7638,1,0,-169,13,-13
7639,1,19,60,15,4
7640,1,10,16,8,2
7641,1,-11,-80,5,-16
7642,1,-29,190,-10,-19
7643,1,5,-234,-13,18
7644,1,16,28,14,2
7645,1,5,-14,-2,7
7646,1,27,180,15,12
7647,1,12,0,12,0
7648,1,7,-78,-6,13
7649,1,24,95,19,5
7650,1,-9,0,-9,0
7651,1,-14,13,-13,-1
7652,1,5,-126,14,-9
7653,1,-27,170,-10,-17
7654,1,21,38,19,2
7655,1,9,-90,-6,15
7656,1,-3,0,0,-3
7657,1,-25,126,-18,-7
7658,1,24,135,9,15
7659,1,-18,77,-7,-11
7660,1,-22,40,-2,-20
7661,1,-9,-52,4,-13
7662,1,-18,-40,2,-20
7663,1,18,81,9,9
7664,1,-28,195,-15,-13
7665,1,-9,-136,-17,8
7666,1,8,-84,-6,14
7667,1,-11,-152,-19,8
7668,1,-17,30,-2,-15
7669,1,1,-380,-19,20
7670,1,-16,60,-6,-10
7671,1,-19,18,-1,-18
7672,1,5,-300,-15,20
7673,1,4,-12,-2,6
7674,1,-12,0,-12,0
7675,1,-2,-63,-9,7
7676,1,-31,240,-16,-15
7677,1,-2,-143,-13,11
7678,1,-9,8,-8,-1
7679,1,13,30,3,10
7680,1,14,40,10,4
7681,1,0,-100,10,-10
7682,1,27,176,11,16
7683,1,-2,-143,11,-13
7684,1,0,-100,10,-10
7685,1,6,-160,16,-10
7686,1,-21,20,-20,-1
7687,1,6,-112,14,-8
7688,1,2,-168,14,-12
7689,1,29,204,12,17
7690,1,35,300,20,15
7691,1,-2,1,-1,-1
7692,1,0,0,0,0
7693,1,15,36,3,12
7694,1,0,-100,10,-10
7695,1,4,-320,20,-16
7696,1,5,-204,17,-12
7697,1,-13,-30,-15,2
7698,1,-30,209,-11,-19
7699,1,-3,-180,-15,12
7700,1,-12,35,-7,-5
7701,1,-9,20,-5,-4
7702,1,3,-180,-12,15
7703,1,30,225,15,15
7704,1,-10,-119,7,-17
7705,1,17,-18,18,-1
7706,1,-7,-44,4,-11
7707,1,-1,-72,-9,8
7708,1,-17,30,-15,-2
7709,1,24,140,10,14
7710,1,-2,-323,17,-19
7711,1,-28,187,-17,-11
7712,1,14,-72,18,-4
7713,1,-30,224,-14,-16
7714,1,-5,0,-5,0
7715,1,-37,340,-17,-20
7716,1,25,154,14,11
7717,1,23,60,20,3
7718,1,-17,72,-8,-9
7719,1,1,-12,4,-3
7720,1,24,128,16,8
7721,1,3,0,0,3
7722,1,21,68,4,17
7723,1,-9,18,-6,-3
7724,1,0,-9,-3,3
7725,1,-8,12,-6,-2
7726,1,-7,12,-4,-3
7727,1,5,-266,-14,19
7728,1,7,-260,-13,20
7729,1,39,380,20,19
7730,1,-22,40,-20,-2
7731,1,-11,24,-3,-8
7732,1,-21,54,-3,-18
7733,1,14,0,0,14
7734,1,-18,-19,1,-19
7735,1,-6,-160,-16,10
7736,1,-18,45,-15,-3
7737,1,-17,72,-9,-8
7738,1,-4,-5,-5,1
7739,1,8,-209,-11,19
7740,1,-10,-11,-11,1
7741,1,-37,342,-18,-19
7742,1,-15,-76,4,-19
7743,1,1,-210,-14,15
7744,1,17,-18,18,-1
7745,1,-10,-144,-18,8
7746,1,8,-180,-10,18
7747,1,27,152,19,8
7748,1,32,255,17,15
7749,1,7,-98,-7,14
7750,1,-33,272,-16,-17
7751,1,36,320,20,16
7752,1,-19,70,-14,-5
7753,1,-6,9,-3,-3
7754,1,-7,10,-5,-2
7755,1,24,119,17,7
7756,1,-3,-304,16,-19
7757,1,3,-238,-14,17
7758,1,27,176,11,16
7759,1,3,-70,-7,10
7760,1,-8,7,-7,-1
7761,1,-10,-24,2,-12
7762,1,40,400,20,20
7763,1,-26,168,-12,-14
7764,1,0,-196,14,-14
7765,1,19,0,0,19
7766,1,-32,240,-20,-12
7767,1,-2,-3,1,-3
7768,1,-37,340,-17,-20
7769,1,4,-60,-6,10
7770,1,4,-77,-7,11
7771,1,-25,144,-9,-16
7772,1,9,14,7,2
7773,1,2,-15,-3,5
7774,1,11,0,11,0
7775,1,-17,66,-6,-11
7776,1,-22,72,-18,-4
7777,1,20,75,15,5
7778,1,2,-323,19,-17
7779,1,28,160,8,20
7780,1,-31,234,-13,-18
7781,1,12,-160,20,-8
7782,1,16,48,12,4
7783,1,-3,-10,2,-5
7784,1,23,102,17,6
7785,1,-16,55,-5,-11
7786,1,8,-209,19,-11
7787,1,-17,72,-9,-8
7788,1,16,-17,-1,17
7789,1,13,-140,-7,20
7790,1,-26,153,-17,-9
7791,1,8,-153,-9,17
7792,1,-12,-64,-16,4
7793,1,27,162,18,9
7794,1,-6,-135,9,-15
7795,1,-6,9,-3,-3
7796,1,-12,-108,6,-18
7797,1,-2,-35,-7,5
7798,1,-29,204,-12,-17
7799,1,22,72,18,4
7800,1,16,60,6,10
7801,1,-26,169,-13,-13
7802,1,-8,-153,-17,9
7803,1,-24,144,-12,-12
7804,1,8,-180,-10,18
7805,1,-15,50,-10,-5
7806,1,7,-170,17,-10
7807,1,2,1,1,1
7808,1,-6,-55,-11,5
7809,1,5,-126,-9,14
7810,1,-4,-60,6,-10
7811,1,27,162,9,18
7812,1,29,190,19,10
7813,1,-1,-30,5,-6
7814,1,-21,108,-9,-12
7815,1,-3,-54,6,-9
7816,1,15,-100,20,-5
7817,1,4,3,3,1
7818,1,-19,34,-17,-2
7819,1,1,-342,-18,19
7820,1,-1,-156,-13,12
7821,1,-15,-34,2,-17
7822,1,6,-72,-6,12
7823,1,8,-128,-8,16
7824,1,25,150,10,15
7825,1,3,-154,-11,14
7826,1,10,-171,-9,19
7827,1,31,228,12,19
7828,1,-9,-136,-17,8
7829,1,-8,-153,9,-17
7830,1,4,-32,8,-4
7831,1,1,-72,-8,9
7832,1,2,-224,-14,16
7833,1,6,-40,-4,10
7834,1,-12,-28,2,-14
7835,1,-16,0,0,-16
7836,1,-8,-84,-14,6
7837,1,-15,-34,-17,2
7838,1,17,66,6,11
7839,1,22,72,4,18
7840,1,-10,-144,8,-18
7841,1,-12,32,-8,-4
7842,1,12,-13,-1,13
7843,1,4,-60,10,-6
7844,1,23,132,11,12
7845,1,-21,110,-10,-11
7846,1,22,96,16,6
7847,1,25,114,19,6
7848,1,16,-17,-1,17
7849,1,7,-170,17,-10
7850,1,4,-12,-2,6
7851,1,2,-48,-6,8
7852,1,-2,-24,4,-6
7853,1,-34,285,-15,-19
7854,1,4,-117,13,-9
7855,1,21,54,3,18
7856,1,9,-10,10,-1
7857,1,26,165,15,11
7858,1,14,24,12,2
7859,1,-20,19,-1,-19
7860,1,-1,-272,-17,16
7861,1,21,38,19,2
7862,1,-3,-88,-11,8
7863,1,7,10,2,5
7864,1,15,-34,17,-2
7865,1,2,-35,-5,7
7866,1,20,96,8,12
7867,1,10,24,4,6
7868,1,0,-16,-4,4
7869,1,-1,-6,-3,2
7870,1,-11,-180,-20,9
7871,1,-3,-70,7,-10
7872,1,-22,57,-3,-19
7873,1,-22,57,-19,-3
7874,1,32,252,18,14
7875,1,-9,8,-1,-8
7876,1,10,-96,16,-6
7877,1,19,18,18,1
7878,1,28,180,10,18
7879,1,-11,28,-7,-4
7880,1,-23,90,-5,-18
7881,1,-18,77,-11,-7
7882,1,19,60,4,15
7883,1,10,9,1,9
7884,1,14,0,14,0
7885,1,1,-72,-8,9
7886,1,22,112,8,14
7887,1,20,0,0,20
7888,1,-9,20,-4,-5
7889,1,-5,-66,6,-11
7890,1,-7,6,-1,-6
7891,1,-6,-112,8,-14
7892,1,14,40,4,10
7893,1,-13,36,-9,-4
7894,1,-19,0,0,-19
7895,1,8,-9,-1,9
7896,1,-16,-36,2,-18
7897,1,28,160,20,8
7898,1,-4,-45,-9,5
7899,1,12,20,2,10
7900,1,-9,14,-2,-7
7901,1,-30,209,-11,-19
7902,1,-7,0,0,-7
7903,1,-27,176,-11,-16
7904,1,-27,152,-19,-8
7905,1,23,126,14,9
7906,1,32,255,17,15
7907,1,30,200,10,20
7908,1,-15,44,-11,-4
7909,1,3,-304,-16,19
7910,1,-1,-210,14,-15
7911,1,1,-342,-18,19
7912,1,32,256,16,16
7913,1,-20,99,-9,-11
7914,1,34,288,16,18
7915,1,-15,-54,3,-18
7916,1,13,-114,-6,19
7917,1,8,-20,-2,10
7918,1,7,-198,18,-11
7919,1,1,-380,20,-19
7920,1,-15,-34,-17,2
7921,1,-27,162,-9,-18
7922,1,8,-33,11,-3
7923,1,39,380,20,19
7924,1,-19,60,-15,-4
7925,1,7,-170,-10,17
7926,1,-18,17,-17,-1
7927,1,-19,0,0,-19
7928,1,-24,140,-10,-14
7929,1,-29,204,-12,-17
7930,1,31,228,12,19
7931,1,-12,-160,-20,8
7932,1,-2,-80,8,-10
7933,1,-8,7,-1,-7
7934,1,-1,-2,-2,1
7935,1,18,-40,20,-2
7936,1,-15,56,-7,-8
7937,1,12,-85,-5,17
7938,1,15,-76,19,-4
7939,1,-21,54,-3,-18
7940,1,-9,-36,-12,3
7941,1,16,63,7,9
7942,1,-14,-15,-15,1
7943,1,11,-126,-7,18
7944,1,-3,-70,7,-10
7945,1,16,55,5,11
7946,1,-14,40,-10,-4
7947,1,0,-36,6,-6
7948,1,-1,-42,6,-7
7949,1,17,66,11,6
7950,1,-24,143,-11,-13
7951,1,-27,152,-19,-8
7952,1,-16,15,-1,-15
7953,1,8,-180,18,-10
7954,1,29,208,13,16
7955,1,-4,-60,6,-10
7956,1,-19,-20,-20,1
7957,1,-24,80,-20,-4
7958,1,-26,153,-9,-17
7959,1,-15,54,-6,-9
7960,1,14,49,7,7
7961,1,19,18,18,1
7962,1,16,-80,-4,20
7963,1,-18,17,-1,-17
7964,1,-20,64,-4,-16
7965,1,30,225,15,15
7966,1,22,105,7,15
7967,1,0,-121,11,-11
7968,1,31,238,14,17
7969,1,26,133,7,19
7970,1,12,0,0,12
7971,1,-32,252,-18,-14
7972,1,-28,187,-17,-11
7973,1,11,28,7,4
7974,1,4,-221,17,-13
7975,1,-4,-5,1,-5
7976,1,9,-162,-9,18
7977,1,24,95,19,5
7978,1,-12,-85,-17,5
7979,1,-16,28,-2,-14
7980,1,9,-90,15,-6
7981,1,-18,-40,2,-20
7982,1,-27,152,-8,-19
7983,1,-26,153,-9,-17
7984,1,-16,15,-1,-15
7985,1,-3,-28,-7,4
7986,1,-19,34,-17,-2
7987,1,10,-39,-3,13
7988,1,-6,-216,-18,12
7989,1,-1,-272,16,-17
7990,1,28,187,17,11
7991,1,1,-30,6,-5
7992,1,4,-60,-6,10
7993,1,8,-153,17,-9
7994,1,-7,-18,-9,2
7995,1,7,-18,-2,9
7996,1,8,-153,17,-9
7997,1,-15,50,-10,-5
7998,1,-5,-126,-14,9
7999,1,7,6,6,1
8000,1,-3,-88,8,-11
8001,1,22,85,17,5
8002,1,-22,85,-17,-5
8003,1,11,-126,18,-7
8004,1,18,0,0,18
8005,1,-17,60,-12,-5
8006,1,-3,-40,-8,5
8007,1,31,220,11,20
8008,1,25,144,16,9
8009,1,-2,-24,-6,4
8010,1,20,64,4,16
8011,1,-17,52,-13,-4
8012,1,-22,117,-9,-13
8013,1,7,-260,-13,20
8014,1,3,2,2,1
8015,1,7,-78,13,-6
8016,1,6,-27,-3,9
8017,1,12,27,9,3
8018,1,-24,128,-8,-16
8019,1,18,80,8,10
8020,1,16,28,14,2
8021,1,-3,-70,7,-10
8022,1,13,-68,17,-4
8023,1,11,-126,18,-7
8024,1,-14,-95,-19,5
8025,1,-16,15,-1,-15
8026,1,-2,-360,18,-20
8027,1,-3,0,0,-3
8028,1,-16,55,-5,-11
8029,1,-5,-104,8,-13
8030,1,26,165,11,15
8031,1,-24,128,-8,-16
8032,1,19,78,6,13
8033,1,-22,96,-6,-16
8034,1,-5,-36,-9,4
8035,1,25,100,20,5
8036,1,30,225,15,15
8037,1,-25,144,-9,-16
8038,1,15,-76,-4,19
8039,1,-8,-180,10,-18
8040,1,-25,136,-17,-8
8041,1,-35,306,-18,-17
8042,1,-3,-4,1,-4
8043,1,32,255,17,15
8044,1,30,200,20,10
8045,1,22,117,9,13
8046,1,0,-225,-15,15
8047,1,7,-78,-6,13
8048,1,-21,90,-6,-15
8049,1,-12,20,-2,-10
8050,1,11,-26,-2,13
8051,1,17,0,0,17
8052,1,10,-171,-9,19
8053,1,16,39,13,3
8054,1,-23,90,-18,-5
8055,1,0,-25,5,-5
8056,1,-4,-5,1,-5
8057,1,-38,361,-19,-19
8058,1,18,32,16,2
8059,1,-5,-266,14,-19
8060,1,15,-54,18,-3
8061,1,31,234,13,18
8062,1,-10,-171,-19,9
8063,1,-23,126,-14,-9
8064,1,-13,22,-11,-2
8065,1,-7,-30,3,-10
8066,1,16,-17,17,-1
8067,1,2,-3,3,-1
8068,1,-16,-57,-19,3
8069,1,-8,7,-1,-7
8070,1,-23,60,-3,-20
8071,1,25,100,5,20
8072,1,16,15,1,15
8073,1,-14,-15,1,-15
8074,1,12,-133,19,-7
8075,1,-31,240,-15,-16
8076,1,-12,11,-11,-1
8077,1,36,323,17,19
8078,1,6,-72,-6,12
8079,1,-14,-72,-18,4
8080,1,-2,-24,4,-6
8081,1,2,-143,-11,13
8082,1,19,18,18,1
8083,1,-16,63,-7,-9
8084,1,-10,0,0,-10
8085,1,-29,204,-12,-17
8086,1,22,85,5,17
8087,1,-20,36,-2,-18
8088,1,-31,238,-17,-14
8089,1,-27,162,-18,-9
8090,1,6,-112,-8,14
8091,1,9,-90,15,-6
8092,1,-30,200,-20,-10
8093,1,-15,36,-3,-12
8094,1,21,80,5,16
8095,1,-10,-39,-13,3
8096,1,20,0,20,0
8097,1,-3,-130,10,-13
8098,1,-21,98,-7,-14
8099,1,-6,-27,-9,3
8100,1,6,-135,15,-9
8101,1,17,-18,18,-1
8102,1,-32,247,-13,-19
8103,1,-12,-160,8,-20
8104,1,-5,-50,5,-10
8105,1,19,48,16,3
8106,1,17,42,14,3
8107,1,-3,-88,8,-11
8108,1,-35,304,-19,-16
8109,1,17,-38,19,-2
8110,1,-2,-24,4,-6
8111,1,4,-21,7,-3
8112,1,-9,-70,-14,5
8113,1,9,-22,11,-2
8114,1,14,0,14,0
8115,1,11,-126,-7,18
8116,1,23,60,20,3
8117,1,-4,-12,-6,2
8118,1,-12,11,-11,-1
8119,1,10,0,10,0
8120,1,-11,18,-2,-9
8121,1,9,-136,-8,17
8122,1,-17,70,-10,-7
8123,1,-17,70,-7,-10
8124,1,-21,38,-19,-2
8125,1,22,112,8,14
8126,1,0,-400,-20,20
8127,1,-15,-76,4,-19
8128,1,-19,70,-5,-14
8129,1,15,50,5,10
8130,1,24,143,13,11
8131,1,-4,-96,8,-12
8132,1,-13,-140,7,-20
8133,1,-15,26,-13,-2
8134,1,4,-77,-7,11
8135,1,31,240,16,15
8136,1,0,-64,-8,8
8137,1,7,-144,16,-9
8138,1,-11,0,0,-11
8139,1,0,-25,-5,5
8140,1,-22,117,-9,-13
8141,1,-5,-234,-18,13
8142,1,-2,-35,5,-7
8143,1,-18,56,-4,-14
8144,1,-12,-160,8,-20
8145,1,-24,143,-11,-13
8146,1,-18,65,-5,-13
8147,1,-11,-152,-19,8
8148,1,-1,-156,12,-13
8149,1,-13,-90,5,-18
8150,1,-3,0,-3,0
8151,1,25,126,7,18
8152,1,-19,0,-19,0
8153,1,-19,0,-19,0
8154,1,18,-19,-1,19
8155,1,-8,16,-4,-4
8156,1,3,-130,13,-10
8157,1,22,120,10,12
8158,1,15,0,0,15
8159,1,-23,126,-9,-14
8160,1,-3,-40,5,-8
8161,1,4,4,2,2
8162,1,6,-135,-9,15
8163,1,23,90,18,5
8164,1,-7,-30,3,-10
8165,1,-19,18,-1,-18
8166,1,8,15,3,5
8167,1,-10,-11,1,-11
8168,1,2,-195,15,-13
8169,1,-6,-216,12,-18
8170,1,33,260,20,13
8171,1,22,117,9,13
8172,1,0,-225,-15,15
8173,1,-1,-182,-14,13
8174,1,6,-91,-7,13
8175,1,-9,-90,6,-15
8176,1,-34,288,-16,-18
8177,1,4,-140,-10,14
8178,1,-15,-16,-16,1
8179,1,-11,24,-3,-8
8180,1,32,255,17,15
8181,1,4,-221,-13,17
8182,1,-4,-320,-20,16
8183,1,-27,176,-11,-16
8184,1,8,-84,14,-6
8185,1,5,-300,20,-15
8186,1,16,39,13,3
8187,1,3,-304,19,-16
8188,1,-7,-78,6,-13
8189,1,-5,-84,-12,7
8190,1,8,-9,-1,9
8191,1,6,8,2,4
8192,1,-24,143,-11,-13
8193,1,12,-45,15,-3
8194,1,6,-40,10,-4
8195,1,15,50,10,5
8196,1,-9,-136,8,-17
8197,1,4,-21,-3,7
8198,1,-4,-32,-8,4
8199,1,-8,12,-2,-6
8200,1,-26,120,-6,-20
8201,1,-26,120,-6,-20
8202,1,-24,95,-19,-5
8203,1,13,-68,17,-4
8204,1,15,-100,20,-5
8205,1,-6,0,-6,0
8206,1,3,-18,-3,6
8207,1,-2,-120,-12,10
8208,1,-12,11,-1,-11
8209,1,-28,160,-8,-20
8210,1,33,260,13,20
8211,1,14,13,1,13
8212,1,14,24,12,2
8213,1,1,-210,15,-14
8214,1,-24,119,-17,-7
8215,1,-3,-18,3,-6
8216,1,-9,0,0,-9
8217,1,-15,26,-2,-13
8218,1,2,-195,-13,15
8219,1,-4,-165,-15,11
8220,1,7,-8,-1,8
8221,1,-22,117,-9,-13
8222,1,-8,-153,9,-17
8223,1,-2,-288,16,-18
8224,1,11,-102,-6,17
8225,1,-4,-140,-14,10
8226,1,11,-12,-1,12
8227,1,-1,-12,-4,3
8228,1,22,105,7,15
8229,1,26,144,18,8
8230,1,5,-104,13,-8
8231,1,-4,-12,-6,2
8232,1,17,66,11,6
8233,1,7,12,4,3
8234,1,-29,180,-20,-9
8235,1,-2,-15,3,-5
8236,1,-4,-96,-12,8
8237,1,9,-22,-2,11
8238,1,9,-70,14,-5
8239,1,9,18,6,3
8240,1,-15,56,-8,-7
8241,1,10,-119,17,-7
8242,1,-2,-80,-10,8
8243,1,0,-324,-18,18
8244,1,9,0,0,9
8245,1,5,6,3,2
8246,1,-11,10,-10,-1
8247,1,-10,-171,9,-19
8248,1,8,7,1,7
8249,1,27,140,7,20
8250,1,-12,35,-7,-5
8251,1,1,-42,-6,7
8252,1,-17,30,-2,-15
8253,1,29,208,13,16
8254,1,-5,-204,-17,12
8255,1,12,32,4,8
8256,1,-13,0,0,-13
8257,1,11,-42,-3,14
8258,1,24,95,19,5
8259,1,-24,135,-9,-15
8260,1,-6,-91,-13,7
8261,1,-26,153,-17,-9
8262,1,4,-320,20,-16
8263,1,15,56,7,8
8264,1,23,132,11,12
8265,1,-1,-72,-9,8
8266,1,-23,120,-15,-8
8267,1,-1,-306,-18,17
8268,1,-1,-110,-11,10
8269,1,-3,0,0,-3
8270,1,7,10,2,5
8271,1,26,165,11,15
8272,1,14,0,0,14
8273,1,-23,130,-13,-10
8274,1,28,192,12,16
8275,1,-27,170,-17,-10
8276,1,19,60,4,15
8277,1,25,100,20,5
8278,1,18,17,1,17
8279,1,21,108,12,9
8280,1,6,-27,9,-3
8281,1,-2,-120,10,-12
8282,1,-19,84,-7,-12
8283,1,23,130,10,13
8284,1,33,260,13,20
8285,1,-9,8,-8,-1
8286,1,-18,-40,2,-20
8287,1,27,180,15,12
8288,1,18,72,12,6
8289,1,-9,-136,8,-17
8290,1,-1,-2,1,-2
8291,1,28,160,20,8
8292,1,3,-54,9,-6
8293,1,39,380,20,19
8294,1,20,51,3,17
8295,1,6,-27,-3,9
8296,1,-11,10,-10,-1
8297,1,-5,-6,-6,1
8298,1,29,198,11,18
8299,1,3,-70,10,-7
8300,1,-24,135,-9,-15
8301,1,7,6,6,1
8302,1,-7,-18,-9,2
8303,1,19,88,11,8
8304,1,-20,64,-16,-4
8305,1,4,3,3,1
8306,1,15,36,3,12
8307,1,33,260,13,20
8308,1,23,102,17,6
8309,1,-7,-98,-14,7
8310,1,11,-60,-4,15
8311,1,-17,-38,2,-19
8312,1,-18,0,0,-18
8313,1,27,180,15,12
8314,1,9,-220,-11,20
8315,1,0,-225,-15,15
8316,1,-30,200,-20,-10
8317,1,8,-48,-4,12
8318,1,-9,-190,-19,10
8319,1,13,-48,-3,16
8320,1,-12,-133,-19,7
8321,1,-27,162,-18,-9
8322,1,12,27,3,9
8323,1,15,36,3,12
8324,1,-15,-16,-16,1
8325,1,16,-80,-4,20
8326,1,-12,0,0,-12
8327,1,33,270,18,15
8328,1,10,-119,17,-7
8329,1,19,34,17,2
8330,1,-12,35,-7,-5
8331,1,-2,-3,1,-3
8332,1,-16,-17,-17,1
8333,1,-12,32,-4,-8
8334,1,9,8,1,8
8335,1,31,234,18,13
8336,1,-10,-171,9,-19
8337,1,-4,-77,-11,7
8338,1,10,-56,-4,14
8339,1,1,-132,12,-11
8340,1,-24,108,-18,-6
8341,1,-11,24,-8,-3
8342,1,9,-10,10,-1
8343,1,-40,400,-20,-20
8344,1,12,20,10,2
8345,1,-1,-72,-9,8
8346,1,-2,-255,15,-17
8347,1,2,-63,9,-7
8348,1,-13,22,-11,-2
8349,1,16,60,10,6
8350,1,-10,-24,2,-12
8351,1,8,-9,-1,9
8352,1,23,102,6,17
8353,1,-10,-39,3,-13
8354,1,5,4,4,1
8355,1,18,81,9,9
8356,1,-23,130,-10,-13
8357,1,2,-255,17,-15
8358,1,15,44,11,4
8359,1,26,120,6,20
8360,1,13,22,2,11
8361,1,-37,342,-19,-18
8362,1,-3,-108,9,-12
8363,1,1,-6,3,-2
8364,1,-28,160,-8,-20
8365,1,-16,39,-13,-3
8366,1,37,340,20,17
8367,1,6,-7,7,-1
8368,1,20,84,6,14
8369,1,1,-110,11,-10
8370,1,11,-152,-8,19
8371,1,7,-228,19,-12
8372,1,12,-28,-2,14
8373,1,10,24,4,6
8374,1,8,-180,-10,18
8375,1,-37,342,-18,-19
8376,1,-11,-80,5,-16
8377,1,-30,200,-10,-20
8378,1,5,-50,-5,10
8379,1,25,126,7,18
8380,1,-32,252,-18,-14
8381,1,-10,24,-4,-6
8382,1,13,22,2,11
8383,1,-3,-40,5,-8
8384,1,-12,-133,-19,7
8385,1,-27,152,-19,-8
8386,1,-24,108,-6,-18
8387,1,-20,75,-15,-5
8388,1,-18,81,-9,-9
8389,1,5,-6,-1,6
8390,1,-13,-90,-18,5
8391,1,11,-26,13,-2
8392,1,-25,144,-9,-16
8393,1,11,0,0,11
8394,1,-9,-10,1,-10
8395,1,-33,266,-14,-19
8396,1,-21,90,-15,-6
8397,1,4,3,1,3
8398,1,2,-323,19,-17
8399,1,29,190,19,10
8400,1,-31,228,-19,-12
8401,1,-20,0,0,-20
8402,1,-32,255,-15,-17
8403,1,18,-40,-2,20
8404,1,-8,-240,12,-20
8405,1,15,-54,-3,18
8406,1,9,-70,-5,14
8407,1,-37,340,-17,-20
8408,1,28,171,9,19
8409,1,-15,36,-12,-3
8410,1,2,-3,-1,3
8411,1,20,75,15,5
8412,1,-15,56,-7,-8
8413,1,0,-4,2,-2
8414,1,-28,192,-12,-16
8415,1,0,-4,2,-2
8416,1,14,-95,-5,19
8417,1,-4,-5,1,-5
8418,1,7,-228,-12,19
8419,1,-6,-112,-14,8
8420,1,16,-80,20,-4
8421,1,7,-260,-13,20
8422,1,-21,80,-16,-5
8423,1,-9,-52,-13,4
8424,1,-18,45,-15,-3
8425,1,5,-176,-11,16
8426,1,25,144,9,16
8427,1,2,-224,-14,16
8428,1,11,18,9,2
8429,1,-15,56,-8,-7
8430,1,5,-6,-1,6
8431,1,-36,324,-18,-18
8432,1,-4,-165,11,-15
8433,1,14,24,12,2
8434,1,6,5,1,5
8435,1,-10,0,-10,0
8436,1,8,-153,-9,17
8437,1,-5,-104,8,-13
8438,1,-11,0,-11,0
8439,1,15,-16,16,-1
8440,1,31,234,18,13
8441,1,-6,-16,-8,2
8442,1,-35,306,-18,-17
8443,1,21,108,12,9
8444,1,-36,323,-17,-19
8445,1,-22,57,-3,-19
8446,1,12,-160,-8,20
8447,1,-9,-10,-10,1
8448,1,1,-42,-6,7
8449,1,-15,50,-10,-5
8450,1,11,-152,-8,19
8451,1,8,-153,17,-9
8452,1,-27,170,-17,-10
8453,1,11,-60,-4,15
8454,1,26,120,6,20
8455,1,6,-27,-3,9
8456,1,-14,-72,4,-18
8457,1,-3,-340,-20,17
8458,1,-11,-12,1,-12
8459,1,2,0,0,2
8460,1,-9,8,-8,-1
8461,1,20,91,13,7
8462,1,19,-20,20,-1
8463,1,39,380,19,20
8464,1,-19,70,-5,-14
8465,1,14,45,9,5
8466,1,-12,27,-9,-3
8467,1,-20,51,-3,-17
8468,1,1,-2,-1,2
8469,1,16,0,0,16
8470,1,31,240,15,16
8471,1,12,27,9,3
8472,1,-5,6,-2,-3
8473,1,12,0,0,12
8474,1,-2,0,0,-2
8475,1,2,-288,-16,18
8476,1,-10,-119,-17,7
8477,1,8,-153,-9,17
8478,1,2,-15,-3,5
8479,1,20,51,17,3
8480,1,-5,-66,6,-11
8481,1,28,187,11,17
8482,1,16,60,6,10
8483,1,-8,-240,12,-20
8484,1,-16,-80,4,-20
8485,1,-22,117,-13,-9
8486,1,17,-60,20,-3
8487,1,21,98,7,14
8488,1,2,-8,4,-2
8489,1,-16,63,-9,-7
8490,1,-20,91,-7,-13
8491,1,10,-96,16,-6
8492,1,-35,306,-17,-18
8493,1,-27,162,-18,-9
8494,1,2,-168,-12,14
8495,1,-21,90,-15,-6
8496,1,26,153,9,17
8497,1,-6,-40,4,-10
8498,1,21,38,19,2
8499,1,1,-210,-14,15
8500,1,14,24,2,12
8501,1,4,-60,-6,10
8502,1,10,-144,18,-8
8503,1,15,36,3,12
8504,1,7,-98,14,-7
8505,1,0,-4,-2,2
8506,1,25,144,16,9
8507,1,3,-208,16,-13
8508,1,25,126,18,7
8509,1,31,228,12,19
8510,1,8,-128,16,-8
8511,1,-21,104,-13,-8
8512,1,4,-21,7,-3
8513,1,-28,196,-14,-14
8514,1,-2,-255,15,-17
8515,1,-2,-48,-8,6
8516,1,-18,81,-9,-9
8517,1,-5,6,-2,-3
8518,1,17,-18,18,-1
8519,1,-16,64,-8,-8
8520,1,19,70,5,14
8521,1,27,152,8,19
8522,1,1,-110,11,-10
8523,1,-14,49,-7,-7
8524,1,6,-40,10,-4
8525,1,-2,-195,-15,13
8526,1,17,0,17,0
8527,1,8,-65,13,-5
8528,1,9,8,1,8
8529,1,-27,182,-13,-14
8530,1,9,-220,-11,20
8531,1,-10,-96,6,-16
8532,1,16,-57,19,-3
8533,1,21,110,11,10
8534,1,-13,22,-2,-11
8535,1,37,342,18,19
8536,1,7,0,7,0
8537,1,-19,90,-9,-10
8538,1,11,28,7,4
8539,1,17,42,14,3
8540,1,-13,42,-6,-7
8541,1,-2,-288,16,-18
8542,1,30,200,20,10
8543,1,-11,24,-3,-8
8544,1,-1,-272,-17,16
8545,1,17,0,0,17
8546,1,-24,108,-6,-18
8547,1,-3,-88,8,-11
8548,1,17,16,16,1
8549,1,7,12,4,3
8550,1,10,-24,-2,12
8551,1,6,0,6,0
8552,1,-3,-18,3,-6
8553,1,5,-14,-2,7
8554,1,-7,-30,-10,3
8555,1,-20,84,-14,-6
8556,1,-39,380,-20,-19
8557,1,-9,18,-6,-3
8558,1,-29,180,-20,-9
8559,1,15,50,10,5
8560,1,-29,180,-20,-9
8561,1,-28,187,-11,-17
8562,1,19,84,7,12
8563,1,-16,-80,4,-20
8564,1,-33,266,-19,-14
8565,1,-1,0,0,-1
8566,1,4,-77,-7,11
8567,1,-10,-200,-20,10
8568,1,-17,-38,2,-19
8569,1,26,144,8,18
8570,1,-16,39,-13,-3
8571,1,16,-17,-1,17
8572,1,18,72,12,6
8573,1,14,-95,-5,19
8574,1,5,-126,14,-9
8575,1,-27,180,-15,-12
8576,1,15,44,11,4
8577,1,-8,0,-8,0
8578,1,22,117,13,9
8579,1,6,-27,-3,9
8580,1,-16,60,-10,-6
8581,1,23,102,17,6
8582,1,-1,-30,5,-6
8583,1,10,-96,16,-6
8584,1,3,-4,-1,4
8585,1,-12,-133,-19,7
8586,1,22,112,8,14
8587,1,20,91,7,13
8588,1,-20,96,-12,-8
8589,1,29,208,13,16
8590,1,4,3,3,1
8591,1,5,-84,12,-7
8592,1,-21,90,-6,-15
8593,1,5,-300,-15,20
8594,1,3,-238,17,-14
8595,1,26,165,15,11
8596,1,-7,6,-6,-1
8597,1,12,-64,-4,16
8598,1,6,8,4,2
8599,1,21,104,13,8
8600,1,-4,-192,12,-16
8601,1,-8,-33,-11,3
8602,1,-3,0,-3,0
8603,1,15,-34,-2,17
8604,1,-23,76,-19,-4
8605,1,-6,-27,3,-9
8606,1,18,65,5,13
8607,1,-9,-22,-11,2
8608,1,-4,-5,1,-5
8609,1,-27,176,-16,-11
8610,1,-11,10,-10,-1
8611,1,13,-48,-3,16
8612,1,-31,228,-12,-19
8613,1,-1,-56,7,-8
8614,1,-23,120,-8,-15
8615,1,-27,170,-17,-10
8616,1,-25,144,-9,-16
8617,1,-6,-247,13,-19
8618,1,-7,-44,-11,4
8619,1,-23,102,-17,-6
8620,1,-2,-288,-18,16
8621,1,4,-192,-12,16
8622,1,-15,-100,-20,5
8623,1,23,120,8,15
8624,1,-24,119,-7,-17
8625,1,-27,162,-9,-18
8626,1,4,-77,11,-7
8627,1,-4,-165,-15,11
8628,1,0,-225,15,-15
8629,1,-10,0,-10,0
8630,1,-2,-224,-16,14
8631,1,3,-54,-6,9
8632,1,-23,120,-8,-15
8633,1,-2,-288,16,-18
8634,1,15,-34,-2,17
8635,1,-10,-75,-15,5
8636,1,-22,121,-11,-11
8637,1,-3,-154,11,-14
8638,1,4,-252,-14,18
8639,1,17,-18,-1,18
8640,1,-33,260,-13,-20
8641,1,16,63,9,7
8642,1,23,90,18,5
8643,1,-28,196,-14,-14
8644,1,-9,-220,11,-20
8645,1,19,48,3,16
8646,1,12,-28,14,-2
8647,1,-10,-200,10,-20
8648,1,8,-33,-3,11
8649,1,18,45,15,3
8650,1,32,255,15,17
8651,1,3,-130,-10,13
8652,1,-17,-38,-19,2
8653,1,-10,0,0,-10
8654,1,-3,-10,2,-5
8655,1,-16,15,-1,-15
8656,1,29,190,19,10
8657,1,-16,48,-12,-4
8658,1,-6,-135,9,-15
8659,1,-11,-152,-19,8
8660,1,-3,0,0,-3
8661,1,-1,-56,-8,7
8662,1,-7,-44,-11,4
8663,1,0,-196,-14,14
8664,1,10,-119,17,-7
8665,1,12,-13,13,-1
8666,1,-2,-255,15,-17
8667,1,-7,6,-6,-1
8668,1,27,176,11,16
8669,1,17,72,8,9
8670,1,11,-180,-9,20
8671,1,13,0,0,13
8672,1,-16,15,-15,-1
8673,1,-13,-68,-17,4
8674,1,-10,-11,1,-11
8675,1,3,-28,7,-4
8676,1,-18,45,-3,-15
8677,1,25,136,8,17
8678,1,15,0,15,0
8679,1,6,-135,15,-9
8680,1,4,-5,5,-1
8681,1,22,72,18,4
8682,1,-9,14,-2,-7
8683,1,27,140,20,7
8684,1,-7,-8,1,-8
8685,1,-5,-104,-13,8
8686,1,-29,210,-14,-15
8687,1,25,114,19,6
8688,1,-34,280,-20,-14
8689,1,-14,-95,-19,5
8690,1,6,-216,18,-12
8691,1,4,-221,17,-13
8692,1,23,76,4,19
8693,1,-22,72,-18,-4
8694,1,-2,-99,9,-11
8695,1,10,9,9,1
8696,1,20,84,6,14
8697,1,-28,180,-10,-18
8698,1,17,52,13,4
8699,1,33,266,19,14
8700,1,-18,72,-12,-6
8701,1,5,6,2,3
8702,1,-9,-10,-10,1
8703,1,-19,78,-6,-13
8704,1,6,-216,-12,18
8705,1,24,135,15,9
8706,1,-13,-114,6,-19
8707,1,-10,-75,5,-15
8708,1,-20,91,-13,-7
8709,1,27,180,12,15
8710,1,-10,-39,3,-13
8711,1,-13,36,-9,-4
8712,1,-22,40,-20,-2
8713,1,10,-119,17,-7
8714,1,-2,-8,-4,2
8715,1,9,-90,-6,15
8716,1,-28,160,-20,-8
8717,1,26,153,17,9
8718,1,7,-260,-13,20
8719,1,-23,130,-10,-13
8720,1,12,-28,-2,14
8721,1,-6,5,-5,-1
8722,1,25,154,14,11
8723,1,-20,19,-1,-19
8724,1,-13,30,-3,-10
8725,1,25,126,18,7
8726,1,-16,48,-4,-12
8727,1,14,-51,-3,17
8728,1,18,0,18,0
8729,1,-17,52,-13,-4
8730,1,20,64,16,4
8731,1,1,-306,18,-17
8732,1,8,16,4,4
8733,1,9,-70,14,-5
8734,1,0,-400,-20,20
8735,1,25,100,20,5
8736,1,-33,270,-18,-15
8737,1,2,-255,-15,17
8738,1,-12,32,-4,-8
8739,1,-2,-80,8,-10
8740,1,5,-14,-2,7
8741,1,-9,-220,11,-20
8742,1,16,15,15,1
8743,1,15,-100,20,-5
8744,1,-32,255,-17,-15
8745,1,-21,20,-1,-20
8746,1,-11,-126,-18,7
8747,1,-19,-20,1,-20
8748,1,0,-4,-2,2
8749,1,-15,-100,5,-20
8750,1,-6,5,-1,-5
8751,1,19,84,7,12
8752,1,-37,342,-19,-18
8753,1,21,90,6,15
8754,1,-13,-140,-20,7
8755,1,36,320,16,20
8756,1,-5,-6,-6,1
8757,1,0,-324,-18,18
8758,1,-25,136,-8,-17
8759,1,22,85,17,5
8760,1,12,-28,14,-2
8761,1,-11,-152,8,-19
8762,1,18,-40,20,-2
8763,1,-10,-144,8,-18
8764,1,24,108,6,18
8765,1,0,-121,-11,11
8766,1,-19,0,-19,0
8767,1,11,-12,-1,12
8768,1,10,-171,-9,19
8769,1,-9,-52,4,-13
8770,1,14,40,4,10
8771,1,-7,-44,-11,4
8772,1,0,-64,8,-8
8773,1,-6,-247,-19,13
8774,1,-5,-300,15,-20
8775,1,15,-34,17,-2
8776,1,-16,15,-1,-15
8777,1,-18,32,-16,-2
8778,1,-30,200,-20,-10
8779,1,-22,40,-20,-2
8780,1,-6,-135,-15,9
8781,1,15,44,11,4
8782,1,1,-110,-10,11
8783,1,0,-361,-19,19
8784,1,-5,-266,14,-19
8785,1,-15,26,-13,-2
8786,1,-10,-119,7,-17
8787,1,20,84,14,6
8788,1,12,20,10,2
8789,1,-10,-200,-20,10
8790,1,-4,-21,-7,3
8791,1,2,-360,-18,20
8792,1,30,209,19,11
8793,1,-26,153,-17,-9
8794,1,-15,36,-12,-3
8795,1,26,160,16,10
8796,1,28,160,8,20
8797,1,24,119,7,17
8798,1,-3,-18,-6,3
8799,1,10,-119,17,-7
8800,1,-12,-45,-15,3
8801,1,10,0,0,10
8802,1,10,-11,11,-1
8803,1,7,-60,12,-5
8804,1,6,0,6,0
8805,1,15,56,8,7
8806,1,-9,-220,-20,11
8807,1,-1,-110,10,-11
8808,1,-8,-209,-19,11
8809,1,24,108,6,18
8810,1,2,-99,-9,11
8811,1,15,44,11,4
8812,1,-26,160,-16,-10
8813,1,-19,18,-18,-1
8814,1,-7,-44,-11,4
8815,1,1,-210,15,-14
8816,1,-20,84,-14,-6
8817,1,-25,136,-17,-8
8818,1,2,0,0,2
8819,1,-19,-20,1,-20
8820,1,25,114,6,19
8821,1,-3,-28,-7,4
8822,1,-17,66,-6,-11
8823,1,34,289,17,17
8824,1,24,135,9,15
8825,1,0,-49,7,-7
8826,1,20,51,17,3
8827,1,9,0,0,9
8828,1,-1,-182,13,-14
8829,1,-7,6,-1,-6
8830,1,4,-96,12,-8
8831,1,18,80,8,10
8832,1,-34,289,-17,-17
8833,1,2,-143,-11,13
8834,1,2,-15,-3,5
8835,1,-8,-48,-12,4
8836,1,-1,-20,-5,4
8837,1,-26,120,-20,-6
8838,1,13,12,12,1
8839,1,9,-220,20,-11
8840,1,14,-15,15,-1
8841,1,-10,-75,-15,5
8842,1,2,-195,-13,15
8843,1,23,126,14,9
8844,1,-18,32,-16,-2
8845,1,9,18,6,3
8846,1,8,-9,9,-1
8847,1,-17,0,0,-17
8848,1,-8,-153,9,-17
8849,1,-2,-255,-17,15
8850,1,12,-13,13,-1
8851,1,-2,-195,-15,13
8852,1,-24,144,-12,-12
8853,1,18,72,6,12
8854,1,6,-247,19,-13
8855,1,25,156,12,13
8856,1,16,0,0,16
8857,1,5,-24,-3,8
8858,1,8,7,1,7
8859,1,-24,108,-18,-6
8860,1,19,90,10,9
8861,1,-4,0,-4,0
8862,1,1,-20,-4,5
8863,1,8,-48,-4,12
8864,1,-4,-77,7,-11
8865,1,-27,170,-10,-17
8866,1,9,-162,18,-9
8867,1,4,-140,-10,14
8868,1,-6,-40,4,-10
8869,1,6,-160,16,-10
8870,1,-5,-6,-6,1
8871,1,9,8,8,1
8872,1,7,6,1,6
8873,1,-7,-198,11,-18
8874,1,30,200,20,10
8875,1,10,-56,14,-4
8876,1,-6,-216,-18,12
8877,1,-14,-95,-19,5
8878,1,-21,38,-19,-2
8879,1,-13,0,0,-13
8880,1,20,99,9,11
8881,1,-14,-120,6,-20
8882,1,-16,-17,1,-17
8883,1,-4,-32,4,-8
8884,1,-21,98,-7,-14
8885,1,1,-210,15,-14
8886,1,29,180,9,20
8887,1,19,34,17,2
8888,1,-13,-14,-14,1
8889,1,1,0,0,1
8890,1,-19,34,-17,-2
8891,1,-14,0,0,-14
8892,1,8,7,1,7
8893,1,-13,40,-5,-8
8894,1,11,-26,-2,13
8895,1,12,-108,18,-6
8896,1,-21,90,-6,-15
8897,1,4,-320,20,-16
8898,1,-9,-22,-11,2
8899,1,-25,114,-6,-19
8900,1,8,-9,-1,9
8901,1,-3,-54,-9,6
8902,1,35,304,19,16
8903,1,18,81,9,9
8904,1,6,-280,-14,20
8905,1,-26,160,-10,-16
8906,1,9,20,4,5
8907,1,35,304,16,19
8908,1,9,-10,-1,10
8909,1,4,-192,16,-12
8910,1,-9,-10,-10,1
8911,1,-28,171,-19,-9
8912,1,9,-136,-8,17
8913,1,38,360,20,18
8914,1,3,-154,14,-11
8915,1,-7,-78,-13,6
8916,1,-7,-30,-10,3
8917,1,-1,-272,16,-17
8918,1,-22,72,-4,-18
8919,1,-25,100,-5,-20
8920,1,-4,-252,14,-18
8921,1,21,38,2,19
8922,1,-6,-280,14,-20
8923,1,-5,4,-4,-1
8924,1,-16,-57,-19,3
8925,1,-10,-11,-11,1
8926,1,-8,-153,9,-17
8927,1,11,-80,16,-5
8928,1,10,9,9,1
8929,1,19,0,0,19
8930,1,-3,-154,11,-14
8931,1,4,-221,-13,17
8932,1,15,26,13,2
8933,1,-2,-360,18,-20
8934,1,7,12,4,3
8935,1,36,320,20,16
8936,1,-20,51,-17,-3
8937,1,-27,140,-20,-7
8938,1,-16,-36,2,-18
8939,1,-11,-102,6,-17
8940,1,29,180,20,9
8941,1,-15,-16,1,-16
8942,1,-14,0,0,-14
8943,1,-10,-39,3,-13
8944,1,32,247,19,13
8945,1,12,-133,-7,19
8946,1,-28,160,-8,-20
8947,1,-25,150,-15,-10
8948,1,-23,112,-16,-7
8949,1,-16,15,-15,-1
8950,1,-18,17,-1,-17
8951,1,37,342,18,19
8952,1,-22,112,-14,-8
8953,1,-3,-40,-8,5
8954,1,3,-154,14,-11
8955,1,-6,9,-3,-3
8956,1,20,51,17,3
8957,1,-7,-260,-20,13
8958,1,-13,40,-8,-5
8959,1,26,153,17,9
8960,1,-9,18,-6,-3
8961,1,-4,0,-4,0
8962,1,-13,-30,-15,2
8963,1,17,16,1,16
8964,1,11,-26,-2,13
8965,1,-1,-132,11,-12
8966,1,2,-15,5,-3
8967,1,-4,-320,-20,16
8968,1,27,182,13,14
8969,1,27,152,8,19
8970,1,0,-4,2,-2
8971,1,8,-180,18,-10
8972,1,-23,90,-5,-18
8973,1,24,108,6,18
8974,1,-20,91,-13,-7
8975,1,8,-153,-9,17
8976,1,17,-60,-3,20
8977,1,-8,-153,-17,9
8978,1,-2,-288,-18,16
8979,1,30,224,16,14
8980,1,-13,42,-6,-7
8981,1,6,-160,16,-10
8982,1,-6,-40,-10,4
8983,1,-17,72,-9,-8
8984,1,-16,15,-1,-15
8985,1,-10,-75,-15,5
8986,1,-32,252,-14,-18
8987,1,-9,0,-9,0
8988,1,-20,75,-5,-15
8989,1,3,-154,14,-11
8990,1,33,272,16,17
8991,1,-24,140,-10,-14
8992,1,4,-96,-8,12
8993,1,10,21,3,7
8994,1,32,255,17,15
8995,1,33,272,16,17
8996,1,13,12,12,1
8997,1,-7,10,-2,-5
8998,1,6,-247,-13,19
8999,1,32,247,19,13
9000,1,10,-24,12,-2
9001,1,6,-16,8,-2
9002,1,0,-49,7,-7
9003,1,-17,42,-3,-14
9004,1,5,-50,-5,10
9005,1,12,-13,13,-1
9006,1,-11,-60,4,-15
9007,1,-31,238,-14,-17
9008,1,15,44,4,11
9009,1,-3,-70,7,-10
9010,1,22,85,5,17
9011,1,35,306,17,18
9012,1,-7,-44,-11,4
9013,1,17,16,1,16
9014,1,-4,-320,16,-20
9015,1,18,72,12,6
9016,1,-31,240,-16,-15
9017,1,10,-39,-3,13
9018,1,-2,-224,14,-16
9019,1,-2,-99,-11,9
9020,1,-8,-128,-16,8
9021,1,2,-120,-10,12
9022,1,4,-60,10,-6
9023,1,23,76,19,4
9024,1,-8,-153,-17,9
9025,1,11,30,5,6
9026,1,-16,28,-14,-2
9027,1,5,-6,-1,6
9028,1,-36,320,-20,-16
9029,1,-14,-51,3,-17
9030,1,5,-176,-11,16
9031,1,25,156,12,13
9032,1,17,30,2,15
9033,1,23,126,14,9
9034,1,-10,-75,5,-15
9035,1,-20,51,-3,-17
9036,1,-13,12,-1,-12
9037,1,22,120,10,12
9038,1,8,-84,-6,14
9039,1,-15,-76,4,-19
9040,1,24,80,20,4
9041,1,-6,-91,7,-13
9042,1,-15,-16,1,-16
9043,1,14,49,7,7
9044,1,-14,13,-1,-13
9045,1,1,-132,12,-11
9046,1,-5,-104,-13,8
9047,1,29,204,17,12
9048,1,-12,27,-9,-3
9049,1,-31,228,-19,-12
9050,1,-23,126,-14,-9
9051,1,1,0,1,0
9052,1,9,-136,-8,17
9053,1,21,54,3,18
9054,1,-28,192,-16,-12
9055,1,28,180,10,18
9056,1,9,-10,-1,10
9057,1,11,-42,-3,14
9058,1,-8,-65,5,-13
9059,1,20,51,17,3
9060,1,10,-75,15,-5
9061,1,7,-60,12,-5
9062,1,-36,324,-18,-18
9063,1,-10,24,-6,-4
9064,1,20,75,15,5
9065,1,2,-168,14,-12
9066,1,4,-60,10,-6
9067,1,-5,-126,-14,9
9068,1,12,20,2,10
9069,1,18,80,8,10
9070,1,2,-63,-7,9
9071,1,15,-16,16,-1
9072,1,-14,-120,6,-20
9073,1,-1,-240,15,-16
9074,1,-13,-14,1,-14
9075,1,-13,-140,7,-20
9076,1,21,20,1,20
9077,1,9,-162,-9,18
9078,1,-1,-156,-13,12
9079,1,3,-28,7,-4
9080,1,21,20,1,20
9081,1,-16,55,-5,-11
9082,1,-4,-21,-7,3
9083,1,-20,91,-7,-13
9084,1,-24,144,-12,-12
9085,1,-11,-42,3,-14
9086,1,-20,75,-15,-5
9087,1,27,170,10,17
9088,1,32,255,15,17
9089,1,-17,70,-7,-10
9090,1,5,-234,18,-13
9091,1,-36,323,-19,-17
9092,1,26,168,14,12
9093,1,1,-156,-12,13
9094,1,4,-12,-2,6
9095,1,-4,-60,6,-10
9096,1,3,-54,-6,9
9097,1,-14,-120,6,-20
9098,1,-11,30,-6,-5
9099,1,-21,98,-7,-14
9100,1,32,247,19,13
9101,1,13,12,1,12
9102,1,5,6,3,2
9103,1,30,209,11,19
9104,1,21,98,14,7
9105,1,-31,220,-11,-20
9106,1,0,-361,19,-19
9107,1,16,-80,-4,20
9108,1,-9,-70,-14,5
9109,1,-31,220,-20,-11
9110,1,-23,120,-15,-8
9111,1,-3,-340,-20,17
9112,1,-19,60,-15,-4
9113,1,-8,-180,-18,10
9114,1,20,75,5,15
9115,1,-8,12,-2,-6
9116,1,8,-9,9,-1
9117,1,32,256,16,16
9118,1,-8,-128,8,-16
9119,1,1,0,0,1
9120,1,-17,52,-4,-13
9121,1,-17,30,-2,-15
9122,1,-9,-112,-16,7
9123,1,-1,-6,-3,2
9124,1,-23,76,-19,-4
9125,1,-4,-285,15,-19
9126,1,0,-49,7,-7
9127,1,9,8,1,8
9128,1,-29,198,-11,-18
9129,1,25,100,5,20
9130,1,28,195,15,13
9131,1,-21,68,-17,-4
9132,1,25,126,18,7
9133,1,-32,256,-16,-16
9134,1,-17,-38,2,-19
9135,1,3,-208,-13,16
9136,1,18,32,16,2
9137,1,23,102,17,6
9138,1,-12,-85,5,-17
9139,1,-7,-260,13,-20
9140,1,-38,360,-18,-20
9141,1,12,-85,-5,17
9142,1,-20,19,-19,-1
9143,1,18,-19,-1,19
9144,1,-14,48,-6,-8
9145,1,17,-38,19,-2
9146,1,6,-40,-4,10
9147,1,-29,208,-16,-13
9148,1,-2,1,-1,-1
9149,1,9,-220,20,-11
9150,1,16,28,14,2
9151,1,21,54,3,18
9152,1,1,-12,-3,4
9153,1,-11,10,-1,-10
9154,1,-9,-190,10,-19
9155,1,-16,55,-5,-11
9156,1,2,-24,6,-4
9157,1,-26,160,-10,-16
9158,1,9,8,1,8
9159,1,10,-96,-6,16
9160,1,-9,-90,-15,6
9161,1,0,-49,7,-7
9162,1,-8,-180,-18,10
9163,1,28,187,11,17
9164,1,0,-121,-11,11
9165,1,-8,-153,9,-17
9166,1,12,20,10,2
9167,1,25,100,5,20
9168,1,6,-187,17,-11
9169,1,3,-130,-10,13
9170,1,1,-12,4,-3
9171,1,13,-140,-7,20
9172,1,5,0,5,0
9173,1,4,-60,10,-6
9174,1,-35,306,-18,-17
9175,1,-23,60,-20,-3
9176,1,17,-18,-1,18
9177,1,10,-171,19,-9
9178,1,-31,240,-15,-16
9179,1,-4,3,-3,-1
9180,1,24,80,4,20
9181,1,16,55,11,5
9182,1,4,-45,9,-5
9183,1,-17,42,-14,-3
9184,1,-15,-16,1,-16
9185,1,-13,36,-9,-4
9186,1,4,-140,-10,14
9187,1,-7,-44,-11,4
9188,1,13,-114,19,-6
9189,1,-22,40,-2,-20
9190,1,7,6,6,1
9191,1,-26,144,-18,-8
9192,1,-8,15,-5,-3
9193,1,-2,-80,-10,8
9194,1,34,288,16,18
9195,1,12,-85,17,-5
9196,1,-2,-288,-18,16
9197,1,22,112,8,14
9198,1,17,60,12,5
9199,1,5,-6,-1,6
9200,1,0,-225,-15,15
9201,1,29,198,18,11
9202,1,-23,130,-10,-13
9203,1,-4,-252,-18,14
9204,1,6,5,5,1
9205,1,10,9,9,1
9206,1,-4,-192,12,-16
9207,1,8,-128,16,-8
9208,1,3,-130,13,-10
9209,1,9,-190,19,-10
9210,1,-2,-120,-12,10
9211,1,-35,300,-20,-15
9212,1,16,28,14,2
9213,1,11,30,6,5
9214,1,-11,-12,1,-12
9215,1,16,48,12,4
9216,1,14,45,9,5
9217,1,5,-50,10,-5
9218,1,4,3,1,3
9219,1,28,195,13,15
9220,1,-17,0,0,-17
9221,1,-18,-40,-20,2
9222,1,-33,260,-20,-13
9223,1,18,81,9,9
9224,1,8,-240,-12,20
9225,1,-29,208,-13,-16
9226,1,-22,105,-7,-15
9227,1,23,102,17,6
9228,1,1,-20,5,-4
9229,1,23,90,5,18
9230,1,-18,32,-2,-16
9231,1,24,108,18,6
9232,1,-3,-304,-19,16
9233,1,22,105,7,15
9234,1,-11,-152,8,-19
9235,1,11,-80,-5,16
9236,1,-1,-12,-4,3
9237,1,-14,0,0,-14
9238,1,38,360,18,20
9239,1,9,-70,-5,14
9240,1,18,56,14,4
9241,1,-10,-200,-20,10
9242,1,-12,20,-2,-10
9243,1,4,-12,-2,6
9244,1,-20,51,-3,-17
9245,1,6,-91,13,-7
9246,1,-26,169,-13,-13
9247,1,6,8,2,4
9248,1,0,-361,19,-19
9249,1,-5,-126,9,-14
9250,1,5,-204,17,-12
9251,1,-15,50,-10,-5
9252,1,1,-20,-4,5
9253,1,2,-143,-11,13
9254,1,4,-192,16,-12
9255,1,-6,-27,-9,3
9256,1,-14,-51,-17,3
9257,1,16,0,0,16
9258,1,-15,14,-1,-14
9259,1,-7,-44,4,-11
9260,1,-22,105,-7,-15
9261,1,23,126,9,14
9262,1,-22,121,-11,-11
9263,1,-5,-84,-12,7
9264,1,0,-4,2,-2
9265,1,-2,-48,6,-8
9266,1,9,0,9,0
9267,1,9,-220,20,-11
9268,1,8,-153,17,-9
9269,1,-9,-90,-15,6
9270,1,13,-140,-7,20
9271,1,-7,-78,6,-13
9272,1,-3,0,0,-3
9273,1,24,80,4,20
9274,1,31,228,12,19
9275,1,8,-209,19,-11
9276,1,-23,90,-5,-18
9277,1,-30,224,-16,-14
9278,1,-8,-20,-10,2
9279,1,-37,340,-20,-17
9280,1,-25,136,-8,-17
9281,1,-12,20,-2,-10
9282,1,28,187,11,17
9283,1,-7,12,-4,-3
9284,1,24,95,19,5
9285,1,-7,-170,10,-17
9286,1,-18,17,-1,-17
9287,1,28,171,9,19
9288,1,3,-180,15,-12
9289,1,-1,-156,12,-13
9290,1,-1,0,-1,0
9291,1,-1,-110,-11,10
9292,1,-7,-30,3,-10
9293,1,21,90,15,6
9294,1,21,54,3,18
9295,1,18,-40,-2,20
9296,1,-12,32,-8,-4
9297,1,6,-55,11,-5
9298,1,-14,13,-1,-13
9299,1,14,-15,15,-1
9300,1,-18,65,-13,-5
9301,1,-12,-108,6,-18
9302,1,-4,-32,4,-8
9303,1,2,-48,8,-6
9304,1,-17,72,-8,-9
9305,1,26,120,20,6
9306,1,-19,70,-5,-14
9307,1,0,-81,9,-9
9308,1,-1,-56,7,-8
9309,1,11,0,0,11
9310,1,18,72,6,12
9311,1,30,224,16,14
9312,1,-34,285,-19,-15
9313,1,-20,91,-13,-7
9314,1,9,-136,-8,17
9315,1,-9,-162,9,-18
9316,1,28,196,14,14
9317,1,-6,-72,-12,6
9318,1,-20,19,-1,-19
9319,1,-28,187,-17,-11
9320,1,19,84,12,7
9321,1,-6,-160,10,-16
9322,1,-17,16,-1,-16
9323,1,-24,144,-12,-12
9324,1,14,-95,-5,19
9325,1,7,-260,20,-13
9326,1,6,0,0,6
9327,1,11,-60,15,-4
9328,1,20,51,3,17
9329,1,0,-49,-7,7
9330,1,-40,400,-20,-20
9331,1,-38,360,-20,-18
9332,1,-11,-180,-20,9
9333,1,23,126,9,14
9334,1,-10,-39,3,-13
9335,1,2,-80,10,-8
9336,1,6,-187,17,-11
9337,1,-3,-18,-6,3
9338,1,0,-16,4,-4
9339,1,25,144,9,16
9340,1,-3,-70,-10,7
9341,1,-35,300,-20,-15
9342,1,13,-140,-7,20
9343,1,3,-108,12,-9
9344,1,-29,190,-10,-19
9345,1,-16,60,-6,-10
9346,1,-31,228,-12,-19
9347,1,10,24,6,4
9348,1,-18,-40,-20,2
9349,1,11,-26,-2,13
9350,1,-9,18,-6,-3
9351,1,-17,42,-14,-3
9352,1,11,-26,-2,13
9353,1,1,-342,-18,19
9354,1,-2,1,-1,-1
9355,1,3,-88,11,-8
9356,1,4,-45,-5,9
9357,1,7,10,5,2
9358,1,-8,-84,6,-14
9359,1,32,240,20,12
9360,1,-10,9,-1,-9
9361,1,11,-26,-2,13
9362,1,-9,-36,3,-12
9363,1,-19,84,-12,-7
9364,1,28,171,19,9
9365,1,14,24,2,12
9366,1,-4,-192,-16,12
9367,1,7,-30,-3,10
9368,1,30,200,10,20
9369,1,23,112,7,16
9370,1,18,45,3,15
9371,1,2,-80,-8,10
9372,1,14,24,2,12
9373,1,-10,9,-1,-9
9374,1,-8,-209,-19,11
9375,1,1,-2,2,-1
9376,1,-31,238,-17,-14
9377,1,-2,-195,13,-15
9378,1,9,-90,15,-6
9379,1,22,120,12,10
9380,1,-3,-4,1,-4
9381,1,1,0,0,1
9382,1,1,-210,-14,15
9383,1,-17,0,-17,0
9384,1,21,80,5,16
9385,1,2,-360,20,-18
9386,1,8,7,1,7
9387,1,-31,240,-16,-15
9388,1,8,-209,-11,19
9389,1,-15,26,-13,-2
9390,1,-8,-180,10,-18
9391,1,-24,135,-9,-15
9392,1,-25,156,-13,-12
9393,1,7,-98,14,-7
9394,1,22,40,2,20
9395,1,-23,120,-15,-8
9396,1,29,210,14,15
9397,1,-12,-133,-19,7
9398,1,-16,60,-10,-6
9399,1,6,-216,18,-12
9400,1,21,20,20,1
9401,1,-1,-90,-10,9
9402,1,11,28,4,7
9403,1,-10,-24,2,-12
9404,1,-30,209,-19,-11
9405,1,-17,16,-16,-1
9406,1,21,110,10,11
9407,1,19,-20,-1,20
9408,1,-4,-117,-13,9
9409,1,-18,56,-14,-4
9410,1,2,-3,3,-1
9411,1,14,-32,-2,16
9412,1,-10,25,-5,-5
9413,1,29,204,17,12
9414,1,-26,153,-9,-17
9415,1,8,-65,13,-5
9416,1,13,40,5,8
9417,1,-8,-48,-12,4
9418,1,-9,8,-8,-1
9419,1,-28,171,-19,-9
9420,1,17,66,6,11
9421,1,-34,288,-18,-16
9422,1,-3,-18,3,-6
9423,1,27,152,19,8
9424,1,1,-380,20,-19
9425,1,-6,-112,8,-14
9426,1,-3,-238,14,-17
9427,1,-7,-120,8,-15
9428,1,2,-120,-10,12
9429,1,2,-99,-9,11
9430,1,3,-130,13,-10
9431,1,-27,162,-18,-9
9432,1,14,45,5,9
9433,1,-27,180,-15,-12
9434,1,-17,0,-17,0
9435,1,31,238,17,14
9436,1,-8,-20,2,-10
9437,1,21,54,3,18
9438,1,3,-18,-3,6
9439,1,-18,80,-10,-8
9440,1,2,-80,10,-8
9441,1,-34,280,-14,-20
9442,1,21,104,8,13
9443,1,12,-133,19,-7
9444,1,2,-24,6,-4
9445,1,9,-220,20,-11
9446,1,0,-196,14,-14
9447,1,-9,14,-2,-7
9448,1,-20,99,-11,-9
9449,1,35,304,19,16
9450,1,2,-255,-15,17
9451,1,9,14,7,2
9452,1,13,-90,-5,18
9453,1,-15,54,-6,-9
9454,1,-8,-128,8,-16
9455,1,-2,-48,6,-8
9456,1,15,14,1,14
9457,1,-10,-11,1,-11
9458,1,-11,-80,5,-16
9459,1,-25,156,-13,-12
9460,1,21,38,19,2
9461,1,-32,247,-19,-13
9462,1,-5,4,-1,-4
9463,1,-1,-272,16,-17
9464,1,6,-27,9,-3
9465,1,-27,182,-14,-13
9466,1,-20,64,-16,-4
9467,1,-1,-12,3,-4
9468,1,-24,135,-15,-9
9469,1,-9,-136,8,-17
9470,1,-24,143,-11,-13
9471,1,2,1,1,1
9472,1,3,2,2,1
9473,1,10,24,4,6
9474,1,-5,-36,4,-9
9475,1,-17,0,0,-17
9476,1,22,85,17,5
9477,1,-25,144,-9,-16
9478,1,3,2,2,1
9479,1,12,-45,-3,15
9480,1,4,-192,16,-12
9481,1,5,-126,14,-9
9482,1,8,15,3,5
9483,1,7,-60,-5,12
9484,1,2,-143,-11,13
9485,1,15,-100,20,-5
9486,1,-12,-13,-13,1
9487,1,-17,66,-11,-6
9488,1,0,-196,-14,14
9489,1,-3,-70,-10,7
9490,1,31,240,16,15
9491,1,-13,40,-5,-8
9492,1,9,-52,13,-4
9493,1,15,-76,19,-4
9494,1,-16,39,-3,-13
9495,1,-17,-18,1,-18
9496,1,-12,-133,7,-19
9497,1,2,-120,-10,12
9498,1,-25,114,-6,-19
9499,1,1,-110,-10,11
9500,1,10,-11,11,-1
9501,1,7,-60,-5,12
9502,1,5,-300,20,-15
9503,1,-2,-8,-4,2
9504,1,-4,-12,-6,2
9505,1,15,-54,-3,18
9506,1,1,-380,20,-19
9507,1,-24,140,-14,-10
9508,1,-39,380,-20,-19
9509,1,2,-48,-6,8
9510,1,-5,-50,-10,5
9511,1,9,-162,18,-9
9512,1,22,105,7,15
9513,1,-6,-112,8,-14
9514,1,16,28,14,2
9515,1,-3,2,-1,-2
9516,1,-8,-128,8,-16
9517,1,-2,0,-2,0
9518,1,-7,-78,-13,6
9519,1,-19,18,-1,-18
9520,1,-24,108,-18,-6
9521,1,-19,88,-11,-8
9522,1,-29,204,-12,-17
9523,1,7,10,5,2
9524,1,19,84,12,7
9525,1,3,-304,19,-16
9526,1,-20,75,-5,-15
9527,1,-12,11,-1,-11
9528,1,4,0,4,0
9529,1,-4,-320,-20,16
9530,1,-16,39,-13,-3
9531,1,-14,0,0,-14
9532,1,-34,288,-16,-18
9533,1,-1,-182,-14,13
9534,1,14,-72,-4,18
9535,1,12,27,3,9
9536,1,7,12,3,4
9537,1,-1,-42,-7,6
9538,1,18,81,9,9
9539,1,-10,0,-10,0
9540,1,25,150,10,15
9541,1,15,36,3,12
9542,1,21,104,13,8
9543,1,24,108,18,6
9544,1,-6,9,-3,-3
9545,1,18,65,5,13
9546,1,0,-256,-16,16
9547,1,-3,-340,17,-20
9548,1,1,-42,-6,7
9549,1,-10,-39,3,-13
9550,1,-25,156,-12,-13
9551,1,-14,49,-7,-7
9552,1,2,-3,3,-1
9553,1,32,256,16,16
9554,1,0,-1,1,-1
9555,1,22,85,5,17
9556,1,12,36,6,6
9557,1,-13,12,-1,-12
9558,1,-19,90,-9,-10
9559,1,9,18,3,6
9560,1,6,-40,10,-4
9561,1,11,30,5,6
9562,1,13,-48,16,-3
9563,1,-28,187,-17,-11
9564,1,6,-112,14,-8
9565,1,30,224,16,14
9566,1,16,-80,-4,20
9567,1,11,-80,16,-5
9568,1,31,234,18,13
9569,1,16,-17,17,-1
9570,1,-9,-36,-12,3
9571,1,6,-247,19,-13
9572,1,-2,-288,16,-18
9573,1,-14,-15,-15,1
9574,1,19,-20,-1,20
9575,1,9,-112,-7,16
9576,1,-35,306,-18,-17
9577,1,0,-64,-8,8
9578,1,21,68,17,4
9579,1,8,-9,-1,9
9580,1,-3,-108,9,-12
9581,1,1,-210,-14,15
9582,1,-1,-90,9,-10
9583,1,2,-15,5,-3
9584,1,5,6,2,3
9585,1,-22,105,-7,-15
9586,1,-2,-8,2,-4
9587,1,-2,-288,16,-18
9588,1,-22,105,-15,-7
9589,1,-3,-208,-16,13
9590,1,-7,12,-4,-3
9591,1,-33,260,-20,-13
9592,1,16,-36,18,-2
9593,1,8,-180,-10,18
9594,1,-38,361,-19,-19
9595,1,-18,77,-7,-11
9596,1,-27,162,-9,-18
9597,1,-18,56,-14,-4
9598,1,18,-40,-2,20
9599,1,-28,180,-10,-18
9600,1,23,76,19,4
9601,1,15,36,3,12
9602,1,-28,195,-15,-13
9603,1,-33,272,-17,-16
9604,1,-38,360,-20,-18
9605,1,-10,-56,4,-14
9606,1,5,-24,8,-3
9607,1,3,-10,-2,5
9608,1,-11,28,-7,-4
9609,1,11,-180,20,-9
9610,1,-35,300,-15,-20
9611,1,6,-16,8,-2
9612,1,24,108,18,6
9613,1,-30,209,-19,-11
9614,1,33,270,18,15
9615,1,0,-196,14,-14
9616,1,34,288,16,18
9617,1,-19,90,-10,-9
9618,1,16,-36,-2,18
9619,1,4,-96,12,-8
9620,1,-17,72,-9,-8
9621,1,-13,-90,5,-18
9622,1,17,42,3,14
9623,1,-20,99,-11,-9
9624,1,7,12,4,3
9625,1,13,-48,16,-3
9626,1,15,-16,16,-1
9627,1,16,0,0,16
9628,1,3,-88,-8,11
9629,1,16,39,3,13
9630,1,-24,143,-13,-11
9631,1,-8,-180,-18,10
9632,1,0,-324,-18,18
9633,1,34,288,16,18
9634,1,25,126,18,7
9635,1,-27,152,-19,-8
9636,1,8,-9,9,-1
9637,1,-5,-66,6,-11
9638,1,0,-361,19,-19
9639,1,10,-171,-9,19
9640,1,8,-209,-11,19
9641,1,-10,16,-2,-8
9642,1,-29,180,-9,-20
9643,1,-32,247,-19,-13
9644,1,18,17,17,1
9645,1,5,-176,-11,16
9646,1,17,-38,19,-2
9647,1,-20,51,-17,-3
9648,1,-3,-154,-14,11
9649,1,4,-117,-9,13
9650,1,3,-54,-6,9
9651,1,-20,91,-13,-7
9652,1,-12,-64,-16,4
9653,1,7,10,2,5
9654,1,-12,11,-1,-11
9655,1,-25,144,-16,-9
9656,1,8,12,2,6
9657,1,-6,-7,-7,1
9658,1,-14,-32,2,-16
9659,1,-22,40,-2,-20
9660,1,14,-95,19,-5
9661,1,-6,0,0,-6
9662,1,13,-30,15,-2
9663,1,15,-34,17,-2
9664,1,20,19,19,1
9665,1,-31,234,-13,-18
9666,1,33,272,17,16
9667,1,-2,-80,8,-10
9668,1,0,-1,-1,1
9669,1,20,91,13,7
9670,1,35,304,19,16
9671,1,29,208,13,16
9672,1,1,-110,11,-10
9673,1,11,-126,18,-7
9674,1,-2,-8,-4,2
9675,1,22,117,13,9
9676,1,14,13,13,1
9677,1,-3,-270,-18,15
9678,1,28,160,8,20
9679,1,31,220,20,11
9680,1,4,-5,-1,5
9681,1,-29,208,-16,-13
9682,1,29,204,17,12
9683,1,-24,80,-20,-4
9684,1,4,-60,10,-6
9685,1,34,285,19,15
9686,1,-3,-304,-19,16
9687,1,-4,-5,-5,1
9688,1,-20,51,-17,-3
9689,1,-3,-304,-19,16
9690,1,-2,-24,4,-6
9691,1,-10,-75,-15,5
9692,1,-11,-12,1,-12
9693,1,-25,114,-19,-6
9694,1,-7,-144,-16,9
9695,1,-18,80,-8,-10
9696,1,3,-208,-13,16
9697,1,18,45,3,15
9698,1,-12,35,-7,-5
9699,1,-19,90,-9,-10
9700,1,25,154,11,14
9701,1,3,-108,-9,12
9702,1,-22,57,-3,-19
9703,1,-16,55,-5,-11
9704,1,-26,169,-13,-13
9705,1,11,0,0,11
9706,1,-11,30,-5,-6
9707,1,1,-306,-17,18
9708,1,-5,-84,-12,7
9709,1,-27,176,-16,-11
9710,1,2,-224,16,-14
9711,1,-5,0,-5,0
9712,1,16,55,11,5
9713,1,-13,30,-3,-10
9714,1,-6,-160,-16,10
9715,1,18,80,10,8
9716,1,3,-28,7,-4
9717,1,0,-49,7,-7
9718,1,30,221,17,13
9719,1,17,30,15,2
9720,1,12,-13,-1,13
9721,1,-1,-210,14,-15
9722,1,-4,-96,-12,8
9723,1,-32,255,-15,-17
9724,1,-31,228,-12,-19
9725,1,-8,-209,-19,11
9726,1,-5,-84,7,-12
9727,1,15,56,7,8
9728,1,-16,64,-8,-8
9729,1,-9,14,-7,-2
9730,1,20,51,17,3
9731,1,-24,128,-8,-16
9732,1,14,33,3,11
9733,1,-15,-34,-17,2
9734,1,-3,-154,11,-14
9735,1,25,154,11,14
9736,1,9,-136,-8,17
9737,1,1,-272,17,-16
9738,1,-2,-3,-3,1
9739,1,-16,39,-13,-3
9740,1,31,220,20,11
9741,1,-26,169,-13,-13
9742,1,32,252,14,18
9743,1,2,-80,10,-8
9744,1,-21,54,-18,-3
9745,1,-6,-216,12,-18
9746,1,-21,20,-20,-1
9747,1,27,170,10,17
9748,1,-12,27,-3,-9
9749,1,-25,100,-5,-20
9750,1,29,198,18,11
9751,1,11,0,11,0
9752,1,13,-114,-6,19
9753,1,-30,224,-16,-14
9754,1,12,11,1,11
9755,1,27,180,12,15
9756,1,-10,9,-1,-9
9757,1,-8,7,-7,-1
9758,1,-25,150,-15,-10
9759,1,12,-28,14,-2
9760,1,19,18,1,18
9761,1,-9,-220,-20,11
9762,1,35,300,20,15
9763,1,34,288,16,18
9764,1,-4,-12,-6,2
9765,1,-8,-153,-17,9
9766,1,-12,20,-10,-2
9767,1,15,-76,-4,19
9768,1,-19,84,-12,-7
9769,1,17,52,4,13
9770,1,-15,50,-5,-10
9771,1,13,36,4,9
9772,1,-11,-102,-17,6
9773,1,15,-16,16,-1
9774,1,-11,-180,9,-20
9775,1,-1,-380,-20,19
9776,1,26,120,20,6
9777,1,-12,20,-2,-10
9778,1,15,36,3,12
9779,1,-6,-27,3,-9
9780,1,-34,280,-14,-20
9781,1,-8,0,0,-8
9782,1,-17,42,-14,-3
9783,1,-29,180,-9,-20
9784,1,14,48,6,8
9785,1,-6,-187,11,-17
9786,1,-11,18,-9,-2
9787,1,-11,10,-1,-10
9788,1,-22,105,-15,-7
9789,1,1,-210,15,-14
9790,1,-14,0,0,-14
9791,1,13,-140,-7,20
9792,1,18,-19,19,-1
9793,1,7,0,0,7
9794,1,22,40,2,20
9795,1,21,108,12,9
9796,1,3,-238,-14,17
9797,1,18,45,3,15
9798,1,-6,-187,-17,11
9799,1,25,150,10,15
9800,1,-12,20,-2,-10
9801,1,-8,-105,7,-15
9802,1,-7,-260,13,-20
9803,1,34,280,14,20
9804,1,-3,-340,-20,17
9805,1,-25,114,-19,-6
9806,1,0,-1,-1,1
9807,1,-20,100,-10,-10
9808,1,-9,-220,11,-20
9809,1,-7,-170,-17,10
9810,1,-12,27,-3,-9
9811,1,9,-22,11,-2
9812,1,35,304,16,19
9813,1,0,-144,12,-12
9814,1,14,49,7,7
9815,1,4,0,0,4
9816,1,-3,-54,6,-9
9817,1,4,-285,19,-15
9818,1,-14,-120,-20,6
9819,1,-17,30,-15,-2
9820,1,16,-17,17,-1
9821,1,-8,-84,6,-14
9822,1,-9,-52,-13,4
9823,1,5,-300,20,-15
9824,1,-2,-24,-6,4
9825,1,11,-180,-9,20
9826,1,-4,-32,4,-8
9827,1,-19,78,-6,-13
9828,1,6,8,4,2
9829,1,0,-4,2,-2
9830,1,-15,-54,-18,3
9831,1,21,68,17,4
9832,1,4,0,4,0
9833,1,-5,-204,12,-17
9834,1,-22,40,-2,-20
9835,1,-6,-187,11,-17
9836,1,2,0,2,0
9837,1,-15,-76,-19,4
9838,1,-23,112,-16,-7
9839,1,-25,154,-14,-11
9840,1,-2,-255,-17,15
9841,1,28,180,18,10
9842,1,19,34,17,2
9843,1,-19,70,-5,-14
9844,1,3,-70,10,-7
9845,1,19,60,15,4
9846,1,23,132,11,12
9847,1,29,180,20,9
9848,1,3,-4,4,-1
9849,1,6,8,4,2
9850,1,-18,-40,2,-20
9851,1,-14,33,-11,-3
9852,1,-5,-24,3,-8
9853,1,-3,-28,4,-7
9854,1,20,91,13,7
9855,1,5,-104,13,-8
9856,1,-8,-48,4,-12
9857,1,-14,45,-5,-9
9858,1,-13,12,-1,-12
9859,1,-6,8,-2,-4
9860,1,-14,-15,1,-15
9861,1,12,-160,-8,20
9862,1,18,80,8,10
9863,1,-20,36,-18,-2
9864,1,-34,280,-14,-20
9865,1,9,-162,-9,18
9866,1,-8,-33,-11,3
9867,1,10,25,5,5
9868,1,6,-247,-13,19
9869,1,0,-25,5,-5
9870,1,-19,0,0,-19
9871,1,33,266,14,19
9872,1,0,-196,14,-14
9873,1,-28,171,-9,-19
9874,1,6,-55,11,-5
9875,1,-21,110,-10,-11
9876,1,37,340,17,20
9877,1,24,128,8,16
9878,1,-2,-168,12,-14
9879,1,-3,-130,10,-13
9880,1,-10,9,-9,-1
9881,1,21,104,8,13
9882,1,3,-88,-8,11
9883,1,5,-14,7,-2
9884,1,-2,-24,-6,4
9885,1,10,-119,-7,17
9886,1,6,-16,-2,8
9887,1,7,-8,-1,8
9888,1,-16,-57,-19,3
9889,1,-5,0,0,-5
9890,1,-3,-70,-10,7
9891,1,-13,-140,-20,7
9892,1,-26,120,-20,-6
9893,1,-14,-15,1,-15
9894,1,-18,65,-13,-5
9895,1,1,-72,-8,9
9896,1,-30,224,-16,-14
9897,1,-2,-8,-4,2
9898,1,2,-48,-6,8
9899,1,11,-26,-2,13
9900,1,9,-36,-3,12
9901,1,0,-25,-5,5
9902,1,8,-48,-4,12
9903,1,-24,140,-14,-10
9904,1,-33,272,-17,-16
9905,1,-2,-99,9,-11
9906,1,-26,168,-12,-14
9907,1,13,12,12,1
9908,1,8,-105,15,-7
9909,1,-34,289,-17,-17
9910,1,29,198,11,18
9911,1,17,16,1,16
9912,1,-30,221,-17,-13
9913,1,-13,-30,2,-15
9914,1,13,12,1,12
9915,1,-8,12,-6,-2
9916,1,-1,-156,-13,12
9917,1,6,-247,19,-13
9918,1,22,121,11,11
9919,1,-17,70,-7,-10
9920,1,9,-36,12,-3
9921,1,-3,-54,-9,6
9922,1,24,135,9,15
9923,1,4,-252,18,-14
9924,1,-28,180,-18,-10
9925,1,0,-225,-15,15
9926,1,13,36,9,4
9927,1,-10,-24,2,-12
9928,1,-9,-112,-16,7
9929,1,-5,-176,11,-16
9930,1,4,-45,-5,9
9931,1,-14,49,-7,-7
9932,1,-3,-304,16,-19
9933,1,28,196,14,14
9934,1,27,176,16,11
9935,1,8,-240,-12,20
9936,1,-7,-170,-17,10
9937,1,25,136,17,8
9938,1,-14,48,-6,-8
9939,1,-4,0,-4,0
9940,1,-11,-80,5,-16
9941,1,-6,-216,-18,12
9942,1,-25,136,-17,-8
9943,1,-21,104,-13,-8
9944,1,-2,-48,6,-8
9945,1,3,2,1,2
9946,1,11,-126,-7,18
9947,1,-10,-144,-18,8
9948,1,-17,0,-17,0
9949,1,12,-45,-3,15
9950,1,15,54,6,9
9951,1,24,128,16,8
9952,1,28,160,20,8
9953,1,-3,-154,-14,11
9954,1,7,10,2,5
9955,1,4,-77,11,-7
9956,1,7,-8,-1,8
9957,1,0,-36,-6,6
9958,1,17,-18,18,-1
9959,1,-26,120,-20,-6
9960,1,-4,-77,-11,7
9961,1,8,-84,-6,14
9962,1,-37,340,-20,-17
9963,1,7,-60,-5,12
9964,1,-16,55,-5,-11
9965,1,-13,30,-3,-10
9966,1,-2,-195,-15,13
9967,1,5,-266,-14,19
9968,1,-2,-195,-15,13
9969,1,-5,-14,2,-7
9970,1,-10,-24,-12,2
9971,1,-2,-323,-19,17
9972,1,-16,-17,1,-17
9973,1,-24,135,-15,-9
9974,1,-15,26,-2,-13
9975,1,38,360,18,20
9976,1,-13,-14,-14,1
9977,1,21,98,14,7
9978,1,-6,-187,-17,11
9979,1,-1,-42,-7,6
9980,1,-21,20,-1,-20
9981,1,-9,-112,7,-16
9982,1,6,-216,-12,18
9983,1,5,-104,-8,13
9984,1,-14,-51,-17,3
9985,1,0,-9,3,-3
9986,1,-13,-90,-18,5
9987,1,0,-49,7,-7
9988,1,10,24,6,4
9989,1,-5,-24,-8,3
9990,1,3,-108,12,-9
9991,1,-15,56,-7,-8
9992,1,24,95,5,19
9993,1,9,-220,-11,20
9994,1,19,70,14,5
9995,1,5,-266,-14,19
9996,1,26,144,18,8
9997,1,-11,-152,-19,8
9998,1,0,-100,10,-10
9999,1,-3,-4,-4,1
10000,1,1,-110,11,-10
