fn #,x^2,x,k,root1,root2
1,1,9,8,8,1
2,1,-5,-50,-10,5
3,1,-32,247,-19,-13
4,1,-15,56,-8,-7
5,1,-15,14,-14,-1
6,1,-8,-33,3,-11
7,1,-2,-35,-7,5
8,1,-8,-48,-12,4
9,1,-2,-168,12,-14
10,1,27,140,20,7
11,1,0,-49,-7,7
12,1,-12,-85,5,-17
13,1,17,-18,-1,18
14,1,-32,255,-17,-15
15,1,2,-168,-12,14
16,1,3,-10,-2,5
17,1,10,-24,12,-2
18,1,29,190,10,19
19,1,-16,39,-13,-3
20,1,8,12,6,2
21,1,-34,280,-14,-20
22,1,-8,0,0,-8
23,1,26,120,20,6
24,1,-15,44,-11,-4
25,1,25,136,8,17
26,1,-18,77,-11,-7
27,1,-24,108,-18,-6
28,1,7,-260,-13,20
29,1,-6,9,-3,-3
30,1,9,14,2,7
31,1,7,-8,8,-1
32,1,-2,0,-2,0
33,1,-12,-160,8,-20
34,1,2,-323,-17,19
35,1,0,-49,-7,7
36,1,9,8,1,8
37,1,-2,-143,-13,11
38,1,16,39,13,3
39,1,-11,-42,-14,3
40,1,1,-380,20,-19
41,1,-27,170,-10,-17
42,1,-16,0,-16,0
43,1,-18,77,-7,-11
44,1,1,-2,2,-1
45,1,31,240,15,16
46,1,-7,-144,-16,9
47,1,-21,80,-5,-16
48,1,-13,-68,-17,4
49,1,32,255,17,15
50,1,-10,25,-5,-5
51,1,19,0,0,19
52,1,-7,-198,11,-18
53,1,7,-144,16,-9
54,1,27,152,19,8
55,1,8,0,8,0
56,1,22,40,20,2
57,1,17,66,11,6
58,1,26,169,13,13
59,1,-31,228,-19,-12
60,1,0,-1,-1,1
61,1,-3,-340,17,-20
62,1,-24,95,-5,-19
63,1,-6,-7,1,-7
64,1,-3,0,-3,0
65,1,18,17,17,1
66,1,20,36,2,18
67,1,15,36,12,3
68,1,6,-40,-4,10
69,1,28,195,13,15
70,1,16,28,2,14
71,1,0,-361,19,-19
72,1,-2,1,-1,-1
73,1,-5,-204,12,-17
74,1,12,-45,-3,15
75,1,12,-45,-3,15
76,1,-29,180,-20,-9
77,1,-2,-15,3,-5
78,1,-25,114,-6,-19
79,1,6,-112,-8,14
80,1,32,252,18,14
81,1,-4,-192,-16,12
82,1,-26,153,-17,-9
83,1,-15,-16,1,-16
84,1,2,-48,-6,8
85,1,8,-105,15,-7
86,1,-19,18,-18,-1
87,1,-13,42,-6,-7
88,1,-32,240,-20,-12
89,1,17,52,4,13
90,1,-5,-84,7,-12
91,1,29,208,16,13
92,1,-12,11,-1,-11
93,1,-15,26,-13,-2
94,1,11,0,0,11
95,1,-23,76,-19,-4
96,1,17,70,10,7
97,1,14,-32,16,-2
98,1,-11,-152,-19,8
99,1,-2,-120,-12,10
100,1,1,-380,-19,20
101,1,11,-152,19,-8
102,1,-9,-90,6,-15
103,1,25,136,17,8
104,1,10,16,8,2
105,1,-9,-136,-17,8
106,1,-11,-26,2,-13
107,1,-34,285,-15,-19
108,1,12,20,2,10
109,1,13,42,7,6
110,1,40,400,20,20
111,1,-1,-90,-10,9
112,1,-16,0,-16,0
113,1,-18,72,-12,-6
114,1,-6,-112,-14,8
115,1,34,285,15,19
116,1,-20,75,-15,-5
117,1,10,-171,19,-9
118,1,32,240,20,12
119,1,5,-104,-8,13
120,1,-19,88,-8,-11
121,1,-6,-247,-19,13
122,1,17,-60,20,-3
123,1,21,38,2,19
124,1,0,-121,-11,11
125,1,-17,60,-12,-5
126,1,-8,-48,4,-12
127,1,15,0,15,0
128,1,-17,16,-1,-16
129,1,-4,-60,-10,6
130,1,0,-196,-14,14
131,1,-3,0,-3,0
132,1,-11,-42,-14,3
133,1,12,32,4,8
134,1,16,-36,-2,18
135,1,-7,10,-2,-5
136,1,-3,-108,9,-12
137,1,27,162,18,9
138,1,-7,12,-4,-3
139,1,-10,-144,-18,8
140,1,-6,5,-5,-1
141,1,-27,180,-15,-12
142,1,-21,110,-11,-10
143,1,3,-28,7,-4
144,1,-21,90,-15,-6
145,1,9,20,5,4
146,1,4,-45,9,-5
147,1,19,18,18,1
148,1,2,-3,-1,3
149,1,-29,210,-14,-15
150,1,2,-48,-6,8
151,1,-11,-12,1,-12
152,1,0,-144,-12,12
153,1,-3,-28,-7,4
154,1,8,12,2,6
155,1,12,27,3,9
156,1,-12,-28,-14,2
157,1,-33,272,-17,-16
158,1,-14,13,-13,-1
159,1,20,91,7,13
160,1,7,-260,-13,20
161,1,28,160,20,8
162,1,-10,-96,-16,6
163,1,23,120,15,8
164,1,0,-49,7,-7
165,1,-9,-190,-19,10
166,1,-20,84,-6,-14
167,1,-15,14,-1,-14
168,1,-12,-133,7,-19
169,1,19,84,12,7
170,1,-6,-112,8,-14
171,1,-14,40,-4,-10
172,1,-3,-4,-4,1
173,1,-4,-45,5,-9
174,1,-11,0,-11,0
175,1,-6,8,-4,-2
176,1,-14,-51,3,-17
177,1,18,-40,20,-2
178,1,12,-28,14,-2
179,1,-33,260,-20,-13
180,1,0,-289,17,-17
181,1,-9,-220,-20,11
182,1,7,-8,8,-1
183,1,27,140,20,7
184,1,-19,60,-15,-4
185,1,0,-36,6,-6
186,1,1,-12,-3,4
187,1,-19,-20,1,-20
188,1,-12,-108,6,-18
189,1,-17,66,-11,-6
190,1,-11,-42,-14,3
191,1,0,-400,-20,20
192,1,-19,-20,-20,1
193,1,-2,-360,18,-20
194,1,-13,40,-5,-8
195,1,-22,57,-19,-3
196,1,-8,-48,-12,4
197,1,-13,42,-7,-6
198,1,3,-108,-9,12
199,1,23,120,8,15
200,1,27,152,19,8
201,1,3,0,3,0
202,1,-2,-143,-13,11
203,1,38,361,19,19
204,1,-1,-272,-17,16
205,1,10,9,9,1
206,1,-6,-16,2,-8
207,1,-22,57,-19,-3
208,1,21,90,15,6
209,1,-3,-28,4,-7
210,1,-12,0,0,-12
211,1,-6,-247,-19,13
212,1,21,54,3,18
213,1,-10,-75,-15,5
214,1,12,0,12,0
215,1,-21,20,-20,-1
216,1,-15,26,-13,-2
217,1,-3,-70,-10,7
218,1,2,-99,-9,11
219,1,-14,48,-6,-8
220,1,29,180,20,9
221,1,8,-209,19,-11
222,1,-2,-24,4,-6
223,1,-17,52,-4,-13
224,1,-20,19,-19,-1
225,1,-9,-190,-19,10
226,1,-38,360,-20,-18
227,1,13,-68,-4,17
228,1,-10,9,-9,-1
229,1,19,78,6,13
230,1,-9,14,-2,-7
231,1,1,-132,12,-11
232,1,-17,-18,1,-18
233,1,39,380,19,20
234,1,-1,-380,19,-20
235,1,-7,-30,-10,3
236,1,22,72,4,18
237,1,-2,1,-1,-1
238,1,-7,-78,6,-13
239,1,18,80,8,10
240,1,18,77,7,11
241,1,-27,162,-9,-18
242,1,-5,-14,2,-7
243,1,-22,96,-6,-16
244,1,-27,152,-19,-8
245,1,-15,56,-7,-8
246,1,7,-260,20,-13
247,1,20,84,6,14
248,1,-14,45,-9,-5
249,1,14,33,3,11
250,1,11,10,1,10
251,1,-28,160,-8,-20
252,1,-29,210,-14,-15
253,1,0,-121,-11,11
254,1,-19,34,-17,-2
255,1,13,-140,-7,20
256,1,16,-17,-1,17
257,1,22,72,18,4
258,1,3,-28,-4,7
259,1,6,8,4,2
260,1,-7,-30,3,-10
261,1,10,-171,19,-9
262,1,4,-221,17,-13
263,1,-31,228,-19,-12
264,1,26,165,15,11
265,1,13,-140,20,-7
266,1,19,78,13,6
267,1,-18,77,-7,-11
268,1,2,-323,19,-17
269,1,7,-78,13,-6
270,1,-15,-100,-20,5
271,1,-12,20,-2,-10
272,1,-10,16,-8,-2
273,1,-22,40,-2,-20
274,1,-5,-24,-8,3
275,1,2,-168,-12,14
276,1,-24,128,-8,-16
277,1,38,361,19,19
278,1,-10,-56,-14,4
279,1,4,-60,10,-6
280,1,-23,102,-17,-6
281,1,-8,12,-6,-2
282,1,10,21,7,3
283,1,10,-39,13,-3
284,1,7,-120,-8,15
285,1,20,75,5,15
286,1,-16,15,-15,-1
287,1,2,0,2,0
288,1,-22,72,-4,-18
289,1,-11,18,-9,-2
290,1,-1,-156,-13,12
291,1,-18,80,-10,-8
292,1,-7,12,-3,-4
293,1,15,-16,16,-1
294,1,5,-24,8,-3
295,1,-8,-105,-15,7
296,1,-26,160,-16,-10
297,1,8,-9,9,-1
298,1,34,288,16,18
299,1,6,-72,-6,12
300,1,-32,240,-20,-12
301,1,-2,-168,-14,12
302,1,1,-6,-2,3
303,1,36,323,19,17
304,1,11,-102,-6,17
305,1,12,32,4,8
306,1,1,-380,-19,20
307,1,-11,30,-5,-6
308,1,-27,170,-17,-10
309,1,7,-120,15,-8
310,1,25,156,12,13
311,1,9,-52,13,-4
312,1,10,-119,-7,17
313,1,26,133,19,7
314,1,-19,78,-6,-13
315,1,15,36,12,3
316,1,5,-204,-12,17
317,1,8,-240,-12,20
318,1,24,128,16,8
319,1,4,-77,11,-7
320,1,1,-42,-6,7
321,1,-25,136,-8,-17
322,1,-19,84,-7,-12
323,1,24,144,12,12
324,1,15,-34,17,-2
325,1,-8,-65,-13,5
326,1,38,360,20,18
327,1,-3,-88,-11,8
328,1,-13,0,-13,0
329,1,21,54,3,18
330,1,4,0,4,0
331,1,-23,90,-18,-5
332,1,6,-247,-13,19
333,1,-20,19,-19,-1
334,1,8,12,6,2
335,1,20,64,4,16
336,1,10,-119,17,-7
337,1,-5,-104,8,-13
338,1,-9,-10,-10,1
339,1,-27,170,-10,-17
340,1,-17,-60,3,-20
341,1,-25,154,-11,-14
342,1,-1,-56,-8,7
343,1,-10,21,-7,-3
344,1,3,-180,-12,15
345,1,11,24,8,3
346,1,6,-187,17,-11
347,1,-5,4,-4,-1
348,1,12,-64,16,-4
349,1,3,-88,11,-8
350,1,-7,-30,-10,3
351,1,-16,-17,1,-17
352,1,-24,143,-11,-13
353,1,-23,130,-13,-10
354,1,-29,180,-9,-20
355,1,-3,-208,13,-16
356,1,14,24,12,2
357,1,-15,-34,-17,2
358,1,-18,45,-15,-3
359,1,25,144,16,9
360,1,31,234,18,13
361,1,-24,128,-16,-8
362,1,-26,120,-6,-20
363,1,13,42,6,7
364,1,10,-24,12,-2
365,1,10,21,3,7
366,1,-22,105,-7,-15
367,1,-23,132,-11,-12
368,1,-12,-108,6,-18
369,1,8,-240,20,-12
370,1,24,128,16,8
371,1,-2,-255,-17,15
372,1,23,112,16,7
373,1,-8,12,-6,-2
374,1,31,238,17,14
375,1,0,-225,15,-15
376,1,-10,9,-9,-1
377,1,-28,180,-18,-10
378,1,1,-132,12,-11
379,1,-2,-255,15,-17
380,1,-22,96,-16,-6
381,1,5,-66,11,-6
382,1,-19,60,-15,-4
383,1,17,16,16,1
384,1,-19,70,-14,-5
385,1,-7,-8,1,-8
386,1,12,36,6,6
387,1,-35,306,-17,-18
388,1,-18,-19,1,-19
389,1,-4,-45,5,-9
390,1,-21,80,-16,-5
391,1,0,-25,-5,5
392,1,-2,-48,6,-8
393,1,25,114,19,6
394,1,14,48,8,6
395,1,-3,0,0,-3
396,1,-10,-56,-14,4
397,1,9,18,3,6
398,1,2,-63,9,-7
399,1,26,168,14,12
400,1,-6,-72,6,-12
401,1,7,-18,9,-2
402,1,15,36,3,12
403,1,4,4,2,2
404,1,-25,136,-17,-8
405,1,-1,0,0,-1
406,1,-6,0,0,-6
407,1,-4,-5,-5,1
408,1,-26,144,-8,-18
409,1,-3,2,-2,-1
410,1,31,240,16,15
411,1,17,70,10,7
412,1,9,-162,-9,18
413,1,-33,270,-15,-18
414,1,5,4,1,4
415,1,-4,3,-3,-1
416,1,21,90,15,6
417,1,15,26,2,13
418,1,-7,-30,-10,3
419,1,8,-9,-1,9
420,1,-16,15,-15,-1
421,1,-7,-78,6,-13
422,1,-15,-100,-20,5
423,1,38,360,20,18
424,1,27,140,7,20
425,1,-1,-30,-6,5
426,1,-6,-135,9,-15
427,1,2,-80,10,-8
428,1,22,120,10,12
429,1,-14,-72,-18,4
430,1,5,-6,-1,6
431,1,-33,270,-15,-18
432,1,-15,26,-13,-2
433,1,13,-48,16,-3
434,1,22,105,15,7
435,1,-7,-198,-18,11
436,1,24,108,18,6
437,1,-13,22,-11,-2
438,1,5,-50,-5,10
439,1,8,12,2,6
440,1,-18,32,-2,-16
441,1,-25,150,-15,-10
442,1,7,-120,15,-8
443,1,19,34,17,2
444,1,-11,18,-9,-2
445,1,-7,-60,5,-12
446,1,31,228,12,19
447,1,27,182,13,14
448,1,-29,208,-16,-13
449,1,6,-7,7,-1
450,1,-29,198,-18,-11
451,1,5,-104,-8,13
452,1,25,100,5,20
453,1,-21,80,-5,-16
454,1,5,-300,-15,20
455,1,-5,-24,3,-8
456,1,-15,14,-14,-1
457,1,17,66,11,6
458,1,2,-143,-11,13
459,1,5,-150,-10,15
460,1,3,-108,12,-9
461,1,23,76,19,4
462,1,-17,70,-7,-10
463,1,31,240,15,16
464,1,-36,320,-20,-16
465,1,4,-60,10,-6
466,1,-8,-153,9,-17
467,1,-6,-7,1,-7
468,1,17,-60,-3,20
469,1,-24,128,-16,-8
470,1,-18,56,-14,-4
471,1,15,-54,-3,18
472,1,26,169,13,13
473,1,14,13,13,1
474,1,7,-98,-7,14
475,1,-14,24,-2,-12
476,1,-4,-21,3,-7
477,1,12,-133,19,-7
478,1,-6,-135,9,-15
479,1,-6,-72,6,-12
480,1,-12,-28,-14,2
481,1,21,110,11,10
482,1,18,32,16,2
483,1,21,108,12,9
484,1,-9,-162,-18,9
485,1,-23,120,-8,-15
486,1,-8,-33,-11,3
487,1,-3,-340,-20,17
488,1,10,-200,-10,20
489,1,29,208,13,16
490,1,3,-304,-16,19
491,1,-1,-6,2,-3
492,1,-12,-108,-18,6
493,1,-13,-48,3,-16
494,1,22,72,18,4
495,1,4,-21,7,-3
496,1,-25,150,-15,-10
497,1,-7,-98,7,-14
498,1,-12,35,-7,-5
499,1,9,20,4,5
500,1,4,-221,17,-13
501,1,3,-88,-8,11
502,1,16,28,14,2
503,1,11,-12,12,-1
504,1,-1,-90,9,-10
505,1,-2,-80,-10,8
506,1,-27,170,-10,-17
507,1,-15,0,0,-15
508,1,10,9,9,1
509,1,9,14,7,2
510,1,9,-52,13,-4
511,1,-17,-60,3,-20
512,1,4,-96,12,-8
513,1,-13,-140,7,-20
514,1,-9,8,-8,-1
515,1,-6,8,-4,-2
516,1,4,-77,-7,11
517,1,-34,285,-15,-19
518,1,25,154,11,14
519,1,-27,140,-20,-7
520,1,-22,57,-3,-19
521,1,-7,-120,8,-15
522,1,1,-90,10,-9
523,1,1,-240,-15,16
524,1,3,-88,-8,11
525,1,-2,-99,9,-11
526,1,10,-171,-9,19
527,1,-17,-18,-18,1
528,1,-8,-240,-20,12
529,1,-11,-12,-12,1
530,1,6,-40,-4,10
531,1,-7,-198,-18,11
532,1,-4,-221,13,-17
533,1,10,-96,-6,16
534,1,-4,-32,4,-8
535,1,12,36,6,6
536,1,4,-285,-15,19
537,1,-36,320,-20,-16
538,1,0,-1,-1,1
539,1,5,6,2,3
540,1,-28,180,-10,-18
541,1,-21,80,-5,-16
542,1,7,-228,-12,19
543,1,10,24,6,4
544,1,0,-100,10,-10
545,1,-17,42,-3,-14
546,1,-20,64,-4,-16
547,1,-16,39,-3,-13
548,1,31,238,14,17
549,1,-14,45,-5,-9
550,1,21,80,16,5
551,1,-28,192,-16,-12
552,1,6,-216,-12,18
553,1,0,-16,-4,4
554,1,24,143,11,13
555,1,22,40,2,20
556,1,11,-180,-9,20
557,1,0,-324,-18,18
558,1,-7,0,-7,0
559,1,13,-68,17,-4
560,1,5,0,5,0
561,1,-2,-255,-17,15
562,1,-15,-16,-16,1
563,1,6,-280,20,-14
564,1,-1,-380,19,-20
565,1,8,-33,-3,11
566,1,-3,-40,-8,5
567,1,19,90,9,10
568,1,-18,-19,1,-19
569,1,-12,0,-12,0
570,1,10,16,2,8
571,1,3,-54,-6,9
572,1,21,80,16,5
573,1,-12,35,-5,-7
574,1,-16,39,-3,-13
575,1,-10,9,-1,-9
576,1,-4,-45,-9,5
577,1,13,42,7,6
578,1,-4,-12,-6,2
579,1,14,49,7,7
580,1,4,-32,8,-4
581,1,6,-91,13,-7
582,1,-22,105,-7,-15
583,1,-3,-28,-7,4
584,1,-4,4,-2,-2
585,1,3,-180,-12,15
586,1,-14,49,-7,-7
587,1,-35,306,-17,-18
588,1,-8,-84,6,-14
589,1,-3,-270,15,-18
590,1,1,-306,18,-17
591,1,-21,38,-19,-2
592,1,-8,12,-2,-6
593,1,32,252,18,14
594,1,18,0,18,0
595,1,14,40,10,4
596,1,19,78,6,13
597,1,18,32,16,2
598,1,6,-280,-14,20
599,1,24,95,5,19
600,1,9,20,5,4
601,1,-9,-90,-15,6
602,1,-25,144,-16,-9
603,1,16,-57,19,-3
604,1,0,-144,12,-12
605,1,13,-68,17,-4
606,1,14,-72,18,-4
607,1,-12,-28,2,-14
608,1,-20,0,0,-20
609,1,3,-304,-16,19
610,1,-1,-380,19,-20
611,1,1,-2,2,-1
612,1,1,-132,-11,12
613,1,12,-28,14,-2
614,1,23,126,14,9
615,1,-10,21,-7,-3
616,1,25,156,13,12
617,1,35,304,16,19
618,1,-14,-15,-15,1
619,1,-36,320,-20,-16
620,1,-5,6,-3,-2
621,1,-14,45,-9,-5
622,1,39,380,20,19
623,1,37,342,19,18
624,1,27,170,17,10
625,1,5,-36,9,-4
626,1,-15,26,-13,-2
627,1,-2,-99,9,-11
628,1,-2,-224,-16,14
629,1,16,55,11,5
630,1,0,-144,-12,12
631,1,19,18,18,1
632,1,-4,3,-1,-3
633,1,-13,12,-12,-1
634,1,-16,-17,-17,1
635,1,-14,48,-6,-8
636,1,1,-12,-3,4
637,1,-19,60,-15,-4
638,1,11,28,7,4
639,1,-16,55,-11,-5
640,1,13,40,8,5
641,1,-31,220,-11,-20
642,1,36,323,17,19
643,1,-17,66,-6,-11
644,1,2,-120,-10,12
645,1,3,-70,-7,10
646,1,16,-57,19,-3
647,1,4,-285,-15,19
648,1,-28,187,-17,-11
649,1,16,-57,19,-3
650,1,-12,27,-3,-9
651,1,-6,8,-4,-2
652,1,-18,17,-17,-1
653,1,-8,-240,12,-20
654,1,-3,-10,2,-5
655,1,-5,-14,-7,2
656,1,-22,120,-10,-12
657,1,-8,-84,-14,6
658,1,14,-120,-6,20
659,1,-11,0,-11,0
660,1,20,84,14,6
661,1,-3,-130,-13,10
662,1,-4,-60,-10,6
663,1,-4,-165,-15,11
664,1,14,-32,16,-2
665,1,12,36,6,6
666,1,22,112,14,8
667,1,13,36,4,9
668,1,8,12,2,6
669,1,9,-112,-7,16
670,1,-9,18,-3,-6
671,1,12,-28,14,-2
672,1,-5,-14,-7,2
673,1,-12,32,-4,-8
674,1,-7,-18,2,-9
675,1,21,38,2,19
676,1,8,15,5,3
677,1,-2,-360,18,-20
678,1,-10,-24,2,-12
679,1,-22,57,-19,-3
680,1,28,187,11,17
681,1,7,-44,-4,11
682,1,16,55,5,11
683,1,-12,27,-3,-9
684,1,12,11,11,1
685,1,-24,128,-8,-16
686,1,22,120,12,10
687,1,0,-169,-13,13
688,1,-13,-68,4,-17
689,1,14,-32,-2,16
690,1,2,-99,11,-9
691,1,28,171,9,19
692,1,6,-160,-10,16
693,1,-3,-180,-15,12
694,1,28,180,10,18
695,1,-27,162,-18,-9
696,1,-14,13,-13,-1
697,1,-23,126,-14,-9
698,1,-21,108,-9,-12
699,1,-10,-24,-12,2
700,1,-14,-32,-16,2
701,1,19,78,13,6
702,1,14,-72,18,-4
703,1,29,210,14,15
704,1,-18,65,-13,-5
705,1,17,52,4,13
706,1,3,0,0,3
707,1,30,224,14,16
708,1,-24,128,-16,-8
709,1,-11,30,-5,-6
710,1,4,-45,-5,9
711,1,-10,0,-10,0
712,1,-17,52,-13,-4
713,1,9,18,6,3
714,1,0,-144,12,-12
715,1,11,18,9,2
716,1,-20,91,-7,-13
717,1,13,-48,-3,16
718,1,-6,8,-2,-4
719,1,-14,40,-4,-10
720,1,-10,-119,-17,7
721,1,1,-132,12,-11
722,1,-22,105,-15,-7
723,1,39,380,20,19
724,1,-33,270,-18,-15
725,1,28,192,16,12
726,1,7,-144,16,-9
727,1,-8,7,-7,-1
728,1,28,192,12,16
729,1,2,-15,5,-3
730,1,2,-63,-7,9
731,1,-17,0,0,-17
732,1,14,40,10,4
733,1,21,98,14,7
734,1,-4,-12,2,-6
735,1,16,-80,-4,20
736,1,-27,182,-14,-13
737,1,4,-285,19,-15
738,1,-2,-24,4,-6
739,1,-6,5,-1,-5
740,1,-29,208,-16,-13
741,1,-1,0,0,-1
742,1,-18,45,-15,-3
743,1,16,63,9,7
744,1,36,323,17,19
745,1,9,0,0,9
746,1,-30,221,-13,-17
747,1,0,-49,-7,7
748,1,-26,168,-14,-12
749,1,12,-160,20,-8
750,1,14,48,6,8
751,1,24,135,9,15
752,1,-6,-112,8,-14
753,1,-29,198,-11,-18
754,1,15,-100,20,-5
755,1,-21,54,-3,-18
756,1,-32,247,-13,-19
757,1,-4,-192,12,-16
758,1,-6,0,-6,0
759,1,-3,-108,-12,9
760,1,39,380,20,19
761,1,-22,117,-9,-13
762,1,-13,-30,2,-15
763,1,-15,-34,-17,2
764,1,-5,-150,-15,10
765,1,8,12,2,6
766,1,-4,-117,9,-13
767,1,-38,360,-20,-18
768,1,10,21,3,7
769,1,20,84,14,6
770,1,3,-108,12,-9
771,1,28,180,10,18
772,1,-13,-140,-20,7
773,1,7,-60,12,-5
774,1,19,34,2,17
775,1,12,32,4,8
776,1,-25,126,-7,-18
777,1,9,-22,11,-2
778,1,-1,-6,-3,2
779,1,-7,-198,11,-18
780,1,-5,-6,1,-6
781,1,0,-256,16,-16
782,1,22,57,3,19
783,1,8,-153,-9,17
784,1,1,0,1,0
785,1,-5,-66,-11,6
786,1,-6,0,-6,0
787,1,3,-28,7,-4
788,1,-29,208,-13,-16
789,1,-3,-270,15,-18
790,1,16,-17,-1,17
791,1,4,-12,-2,6
792,1,6,-27,-3,9
793,1,-30,225,-15,-15
794,1,19,48,16,3
795,1,25,144,16,9
796,1,-4,-77,-11,7
797,1,-20,100,-10,-10
798,1,-20,96,-12,-8
799,1,27,152,19,8
800,1,-15,0,-15,0
801,1,14,-120,-6,20
802,1,22,112,14,8
803,1,-31,220,-20,-11
804,1,0,-400,20,-20
805,1,-32,256,-16,-16
806,1,8,-105,15,-7
807,1,5,-104,13,-8
808,1,34,289,17,17
809,1,32,247,13,19
810,1,19,70,14,5
811,1,5,-84,12,-7
812,1,32,247,19,13
813,1,-3,-18,3,-6
814,1,25,114,6,19
815,1,-25,144,-9,-16
816,1,-2,-63,7,-9
817,1,22,105,7,15
818,1,-31,228,-12,-19
819,1,33,266,14,19
820,1,11,-152,19,-8
821,1,15,-34,-2,17
822,1,23,60,3,20
823,1,0,-289,-17,17
824,1,-13,-14,-14,1
825,1,-5,-6,-6,1
826,1,-5,-150,10,-15
827,1,-6,-280,-20,14
828,1,3,-108,12,-9
829,1,-13,0,0,-13
830,1,33,272,17,16
831,1,-29,180,-9,-20
832,1,-16,-17,1,-17
833,1,-22,120,-12,-10
834,1,7,-60,12,-5
835,1,-7,-144,-16,9
836,1,-1,-306,17,-18
837,1,26,120,6,20
838,1,-6,-27,-9,3
839,1,0,-196,-14,14
840,1,24,119,7,17
841,1,-20,51,-3,-17
842,1,27,152,19,8
843,1,1,-182,14,-13
844,1,-29,180,-20,-9
845,1,-8,-180,-18,10
846,1,-7,0,-7,0
847,1,8,0,0,8
848,1,1,-272,17,-16
849,1,30,200,20,10
850,1,-11,10,-10,-1
851,1,27,152,8,19
852,1,-27,152,-19,-8
853,1,-22,72,-4,-18
854,1,-25,156,-13,-12
855,1,0,-16,-4,4
856,1,9,18,3,6
857,1,-36,323,-17,-19
858,1,-5,-14,2,-7
859,1,-11,-102,6,-17
860,1,11,30,6,5
861,1,-14,24,-12,-2
862,1,0,-289,-17,17
863,1,-24,128,-8,-16
864,1,0,-121,11,-11
865,1,13,40,5,8
866,1,-21,104,-8,-13
867,1,-17,-18,1,-18
868,1,0,-4,2,-2
869,1,-14,48,-8,-6
870,1,24,135,9,15
871,1,-2,-195,-15,13
872,1,-2,-360,18,-20
873,1,-4,-12,2,-6
874,1,11,30,6,5
875,1,20,36,18,2
876,1,17,42,14,3
877,1,-17,72,-8,-9
878,1,-2,-15,-5,3
879,1,-10,9,-1,-9
880,1,-28,187,-11,-17
881,1,2,-195,15,-13
882,1,-1,-2,1,-2
883,1,-20,36,-18,-2
884,1,-33,260,-13,-20
885,1,-18,32,-2,-16
886,1,4,-192,-12,16
887,1,-12,-13,-13,1
888,1,-8,-180,-18,10
889,1,11,-42,-3,14
890,1,-3,-88,8,-11
891,1,-15,-16,-16,1
892,1,-16,64,-8,-8
893,1,6,-187,-11,17
894,1,-1,-132,11,-12
895,1,-1,-272,-17,16
896,1,-21,98,-14,-7
897,1,8,-105,-7,15
898,1,19,70,5,14
899,1,16,39,3,13
900,1,6,8,2,4
901,1,-7,-260,13,-20
902,1,2,-323,19,-17
903,1,9,-70,-5,14
904,1,6,-160,16,-10
905,1,-16,-17,-17,1
906,1,10,-119,-7,17
907,1,-33,272,-17,-16
908,1,-14,-32,2,-16
909,1,10,16,2,8
910,1,-2,-48,-8,6
911,1,-12,-64,4,-16
912,1,-1,-110,-11,10
913,1,24,128,8,16
914,1,12,-133,-7,19
915,1,-9,-22,2,-11
916,1,2,-35,7,-5
917,1,-1,-156,12,-13
918,1,0,-289,-17,17
919,1,-10,21,-3,-7
920,1,11,-42,-3,14
921,1,1,-156,-12,13
922,1,2,-224,-14,16
923,1,-10,-171,-19,9
924,1,10,-171,19,-9
925,1,6,-216,-12,18
926,1,7,-144,16,-9
927,1,0,-196,-14,14
928,1,29,190,19,10
929,1,-12,27,-9,-3
930,1,1,-156,-12,13
931,1,-17,66,-6,-11
932,1,4,-60,10,-6
933,1,0,-25,5,-5
934,1,-8,-84,-14,6
935,1,18,45,15,3
936,1,-14,49,-7,-7
937,1,1,-132,-11,12
938,1,-5,-300,-20,15
939,1,9,-36,12,-3
940,1,22,57,19,3
941,1,27,152,19,8
942,1,-11,18,-2,-9
943,1,-7,12,-3,-4
944,1,-6,-160,-16,10
945,1,6,-160,16,-10
946,1,10,-56,14,-4
947,1,-20,19,-19,-1
948,1,7,-78,13,-6
949,1,12,11,1,11
950,1,7,-8,-1,8
951,1,-1,-72,8,-9
952,1,8,-33,-3,11
953,1,-15,-100,5,-20
954,1,-35,306,-18,-17
955,1,29,204,12,17
956,1,13,-14,14,-1
957,1,16,39,3,13
958,1,8,12,2,6
959,1,20,51,3,17
960,1,-8,15,-3,-5
961,1,-35,304,-16,-19
962,1,8,-153,-9,17
963,1,36,323,19,17
964,1,12,27,9,3
965,1,-4,-252,14,-18
966,1,7,12,3,4
967,1,-9,8,-1,-8
968,1,-11,-152,8,-19
969,1,-19,34,-2,-17
970,1,-9,-70,5,-14
971,1,-10,21,-7,-3
972,1,17,66,11,6
973,1,24,80,4,20
974,1,18,-40,-2,20
975,1,14,24,2,12
976,1,0,-25,-5,5
977,1,-9,-36,3,-12
978,1,-2,-224,-16,14
979,1,-14,13,-1,-13
980,1,-21,20,-20,-1
981,1,24,95,5,19
982,1,27,176,11,16
983,1,-12,32,-4,-8
984,1,-23,102,-6,-17
985,1,31,240,15,16
986,1,-6,9,-3,-3
987,1,39,380,20,19
988,1,-9,18,-6,-3
989,1,-21,20,-20,-1
990,1,21,108,12,9
991,1,-25,156,-12,-13
992,1,20,99,9,11
993,1,1,-306,18,-17
994,1,-19,90,-9,-10
995,1,18,81,9,9
996,1,3,0,0,3
997,1,-19,70,-5,-14
998,1,12,36,6,6
999,1,11,-12,12,-1
1000,1,5,-150,15,-10
1001,1,14,40,4,10
1002,1,-29,180,-9,-20
1003,1,-3,-238,14,-17
1004,1,-23,90,-18,-5
1005,1,34,280,20,14
1006,1,-14,-120,6,-20
1007,1,-20,75,-15,-5
1008,1,8,-84,-6,14
1009,1,-10,-24,-12,2
1010,1,1,-20,5,-4
1011,1,-1,-6,2,-3
1012,1,-11,-152,-19,8
1013,1,5,-126,-9,14
1014,1,7,-198,-11,18
1015,1,33,272,17,16
1016,1,6,-216,-12,18
1017,1,-9,-22,-11,2
1018,1,-10,24,-4,-6
1019,1,10,-200,20,-10
1020,1,-20,84,-14,-6
1021,1,-28,171,-19,-9
1022,1,1,-210,-14,15
1023,1,-2,-80,8,-10
1024,1,-13,22,-11,-2
1025,1,2,-360,20,-18
1026,1,-20,19,-19,-1
1027,1,24,108,6,18
1028,1,31,220,11,20
1029,1,33,272,16,17
1030,1,-15,-100,5,-20
1031,1,26,153,17,9
1032,1,6,0,6,0
1033,1,-24,143,-11,-13
1034,1,29,180,9,20
1035,1,3,-208,16,-13
1036,1,-12,-64,-16,4
1037,1,26,153,17,9
1038,1,-20,100,-10,-10
1039,1,4,-77,11,-7
1040,1,16,48,12,4
1041,1,-9,-220,11,-20
1042,1,-3,-208,-16,13
1043,1,31,228,12,19
1044,1,-3,-18,3,-6
1045,1,16,64,8,8
1046,1,-4,-96,-12,8
1047,1,22,120,12,10
1048,1,-6,-91,7,-13
1049,1,-3,-304,16,-19
1050,1,19,0,0,19
1051,1,-28,160,-20,-8
1052,1,-3,-4,-4,1
1053,1,6,5,1,5
1054,1,-2,-99,9,-11
1055,1,-24,119,-7,-17
1056,1,3,-70,-7,10
1057,1,17,60,12,5
1058,1,31,228,19,12
1059,1,8,-33,-3,11
1060,1,13,22,11,2
1061,1,2,-255,17,-15
1062,1,32,240,20,12
1063,1,25,114,19,6
1064,1,-14,40,-4,-10
1065,1,-13,-140,-20,7
1066,1,21,68,17,4
1067,1,-6,-16,-8,2
1068,1,-1,-72,-9,8
1069,1,23,102,6,17
1070,1,-12,0,-12,0
1071,1,3,-130,-10,13
1072,1,0,-64,-8,8
1073,1,10,-96,16,-6
1074,1,-23,102,-6,-17
1075,1,0,-256,-16,16
1076,1,8,16,4,4
1077,1,13,30,3,10
1078,1,-7,-260,13,-20
1079,1,-32,252,-18,-14
1080,1,8,-240,20,-12
1081,1,-26,168,-12,-14
1082,1,-23,132,-11,-12
1083,1,-10,-119,-17,7
1084,1,-8,-84,-14,6
1085,1,3,-270,18,-15
1086,1,-26,133,-19,-7
1087,1,9,18,6,3
1088,1,-24,128,-8,-16
1089,1,8,7,7,1
1090,1,-21,108,-12,-9
1091,1,3,-270,-15,18
1092,1,13,42,7,6
1093,1,23,76,4,19
1094,1,-26,144,-18,-8
1095,1,-1,-2,-2,1
1096,1,1,-72,9,-8
1097,1,-3,-270,-18,15
1098,1,16,15,1,15
1099,1,-5,0,0,-5
1100,1,-9,-112,7,-16
1101,1,5,-126,-9,14
1102,1,18,77,11,7
1103,1,-9,-10,-10,1
1104,1,-9,-10,-10,1
1105,1,8,-20,-2,10
1106,1,16,63,9,7
1107,1,4,-21,-3,7
1108,1,17,52,4,13
1109,1,-14,40,-4,-10
1110,1,-17,66,-6,-11
1111,1,31,228,19,12
1112,1,12,-85,17,-5
1113,1,-9,-70,-14,5
1114,1,-3,-28,4,-7
1115,1,7,6,6,1
1116,1,10,-11,11,-1
1117,1,7,10,2,5
1118,1,-26,144,-8,-18
1119,1,6,-112,-8,14
1120,1,-33,260,-20,-13
1121,1,-23,90,-5,-18
1122,1,20,91,13,7
1123,1,6,0,0,6
1124,1,-12,-108,6,-18
1125,1,1,-90,10,-9
1126,1,5,-14,-2,7
1127,1,4,-45,-5,9
1128,1,26,160,10,16
1129,1,4,-117,-9,13
1130,1,-10,9,-9,-1
1131,1,33,266,19,14
1132,1,8,-9,-1,9
1133,1,12,20,10,2
1134,1,-10,0,0,-10
1135,1,9,-70,-5,14
1136,1,-21,98,-14,-7
1137,1,37,342,19,18
1138,1,-5,-300,-20,15
1139,1,0,-256,16,-16
1140,1,11,10,10,1
1141,1,2,-24,-4,6
1142,1,-3,-154,-14,11
1143,1,29,210,15,14
1144,1,-9,8,-8,-1
1145,1,4,-252,18,-14
1146,1,-5,-24,-8,3
1147,1,8,-33,-3,11
1148,1,-12,11,-11,-1
1149,1,-1,-6,-3,2
1150,1,1,0,0,1
1151,1,-3,-154,-14,11
1152,1,-2,-8,-4,2
1153,1,5,-150,15,-10
1154,1,-9,-220,-20,11
1155,1,-16,28,-2,-14
1156,1,26,169,13,13
1157,1,-3,-238,-17,14
1158,1,22,57,3,19
1159,1,16,63,7,9
1160,1,9,-10,-1,10
1161,1,28,160,8,20
1162,1,19,90,9,10
1163,1,14,-32,-2,16
1164,1,-19,0,-19,0
1165,1,9,14,2,7
1166,1,11,10,1,10
1167,1,2,-48,-6,8
1168,1,-19,78,-6,-13
1169,1,-5,-150,-15,10
1170,1,10,-56,14,-4
1171,1,-17,-38,2,-19
1172,1,-7,12,-4,-3
1173,1,19,90,9,10
1174,1,15,50,5,10
1175,1,-17,-38,-19,2
1176,1,1,-30,6,-5
1177,1,32,255,15,17
1178,1,-30,221,-13,-17
1179,1,-19,90,-9,-10
1180,1,-1,-306,-18,17
1181,1,25,136,8,17
1182,1,-9,-10,-10,1
1183,1,-22,112,-14,-8
1184,1,-17,30,-15,-2
1185,1,1,-90,10,-9
1186,1,7,-228,19,-12
1187,1,-6,-7,1,-7
1188,1,-21,20,-1,-20
1189,1,7,-60,-5,12
1190,1,18,-40,-2,20
1191,1,6,-247,-13,19
1192,1,22,121,11,11
1193,1,15,0,15,0
1194,1,-10,16,-8,-2
1195,1,-10,-24,-12,2
1196,1,-9,14,-2,-7
1197,1,-8,-209,-19,11
1198,1,16,39,3,13
1199,1,19,88,11,8
1200,1,0,-196,-14,14
1201,1,-9,-10,-10,1
1202,1,-32,252,-14,-18
1203,1,-6,-280,-20,14
1204,1,4,-21,7,-3
1205,1,17,-60,20,-3
1206,1,-8,0,0,-8
1207,1,-7,-30,-10,3
1208,1,12,-45,15,-3
1209,1,-9,-36,3,-12
1210,1,35,304,16,19
1211,1,-13,36,-9,-4
1212,1,3,-180,-12,15
1213,1,-5,-84,-12,7
1214,1,-12,-85,-17,5
1215,1,-21,110,-10,-11
1216,1,-18,81,-9,-9
1217,1,1,-30,6,-5
1218,1,-7,-44,4,-11
1219,1,-1,-156,12,-13
1220,1,-17,30,-2,-15
1221,1,-15,56,-8,-7
1222,1,-4,-221,13,-17
1223,1,1,-72,-8,9
1224,1,13,-114,-6,19
1225,1,-22,117,-9,-13
1226,1,-13,-90,5,-18
1227,1,-37,342,-19,-18
1228,1,6,-160,16,-10
1229,1,1,-210,-14,15
1230,1,26,120,6,20
1231,1,-12,-133,-19,7
1232,1,3,-28,7,-4
1233,1,-17,42,-14,-3
1234,1,2,-99,-9,11
1235,1,1,-6,3,-2
1236,1,-2,-15,-5,3
1237,1,-15,36,-3,-12
1238,1,-5,-266,14,-19
1239,1,-11,0,-11,0
1240,1,-6,-40,-10,4
1241,1,-3,-154,11,-14
1242,1,4,-285,-15,19
1243,1,-7,-228,-19,12
1244,1,-17,-60,-20,3
1245,1,-2,-63,-9,7
1246,1,5,-66,11,-6
1247,1,-28,171,-19,-9
1248,1,-4,-96,-12,8
1249,1,14,-72,18,-4
1250,1,2,-323,-17,19
1251,1,7,-78,-6,13
1252,1,-35,304,-19,-16
1253,1,-29,208,-13,-16
1254,1,-5,-126,9,-14
1255,1,-6,-280,-20,14
1256,1,-4,-252,14,-18
1257,1,-32,240,-20,-12
1258,1,-13,-14,-14,1
1259,1,-33,266,-19,-14
1260,1,29,210,14,15
1261,1,0,-81,9,-9
1262,1,5,-266,-14,19
1263,1,-4,-5,1,-5
1264,1,-17,60,-5,-12
1265,1,30,216,12,18
1266,1,20,0,0,20
1267,1,-30,216,-12,-18
1268,1,12,32,4,8
1269,1,-4,-117,9,-13
1270,1,-5,-24,3,-8
1271,1,-38,361,-19,-19
1272,1,-11,-152,-19,8
1273,1,-7,-60,5,-12
1274,1,5,-104,-8,13
1275,1,-35,304,-16,-19
1276,1,7,-44,11,-4
1277,1,-6,-280,14,-20
1278,1,-29,208,-13,-16
1279,1,-7,-260,13,-20
1280,1,-9,-162,-18,9
1281,1,-27,162,-18,-9
1282,1,5,0,5,0
1283,1,-9,-22,-11,2
1284,1,-3,-40,-8,5
1285,1,13,22,11,2
1286,1,-34,288,-16,-18
1287,1,6,-91,13,-7
1288,1,-2,1,-1,-1
1289,1,23,112,7,16
1290,1,-29,208,-13,-16
1291,1,10,-75,-5,15
1292,1,12,11,11,1
1293,1,27,170,17,10
1294,1,-2,-99,9,-11
1295,1,-17,52,-4,-13
1296,1,-14,-51,3,-17
1297,1,11,24,3,8
1298,1,12,-45,15,-3
1299,1,-8,-65,-13,5
1300,1,16,63,9,7
1301,1,-13,42,-7,-6
1302,1,-25,154,-11,-14
1303,1,-19,60,-15,-4
1304,1,-13,-68,-17,4
1305,1,9,-136,-8,17
1306,1,-19,-20,-20,1
1307,1,1,-12,4,-3
1308,1,-17,-18,-18,1
1309,1,-13,-68,4,-17
1310,1,-6,8,-2,-4
1311,1,-25,126,-18,-7
1312,1,-7,-198,11,-18
1313,1,-12,-85,5,-17
1314,1,12,-85,17,-5
1315,1,-32,240,-12,-20
1316,1,25,126,7,18
1317,1,7,-78,-6,13
1318,1,-22,112,-8,-14
1319,1,3,-40,8,-5
1320,1,22,85,5,17
1321,1,-29,190,-19,-10
1322,1,-21,20,-20,-1
1323,1,29,180,9,20
1324,1,-6,-40,4,-10
1325,1,4,-32,-4,8
1326,1,27,176,11,16
1327,1,-5,4,-1,-4
1328,1,27,140,7,20
1329,1,-18,80,-8,-10
1330,1,9,-136,-8,17
1331,1,-17,0,-17,0
1332,1,-20,75,-15,-5
1333,1,-4,-252,-18,14
1334,1,-9,14,-7,-2
1335,1,-19,34,-2,-17
1336,1,27,140,20,7
1337,1,19,60,4,15
1338,1,2,0,2,0
1339,1,9,-112,-7,16
1340,1,-3,-4,1,-4
1341,1,-30,224,-14,-16
1342,1,0,-256,-16,16
1343,1,17,60,12,5
1344,1,27,180,12,15
1345,1,19,0,19,0
1346,1,-15,-54,3,-18
1347,1,1,-90,-9,10
1348,1,14,45,5,9
1349,1,15,-76,19,-4
1350,1,9,-136,17,-8
1351,1,26,133,7,19
1352,1,7,-260,20,-13
1353,1,3,-28,7,-4
1354,1,0,-121,11,-11
1355,1,-18,17,-1,-17
1356,1,-1,-110,10,-11
1357,1,2,-63,-7,9
1358,1,-24,143,-11,-13
1359,1,12,-28,-2,14
1360,1,8,15,3,5
1361,1,-22,40,-20,-2
1362,1,-5,0,-5,0
1363,1,26,165,15,11
1364,1,37,342,19,18
1365,1,-19,90,-9,-10
1366,1,22,112,14,8
1367,1,5,-66,-6,11
1368,1,10,21,3,7
1369,1,23,130,13,10
1370,1,11,28,7,4
1371,1,-24,95,-19,-5
1372,1,16,-80,20,-4
1373,1,-28,160,-20,-8
1374,1,0,-225,-15,15
1375,1,-6,-72,6,-12
1376,1,12,-45,-3,15
1377,1,-16,-36,-18,2
1378,1,-1,0,-1,0
1379,1,16,63,7,9
1380,1,7,-120,-8,15
1381,1,-8,-153,-17,9
1382,1,-16,-17,1,-17
1383,1,32,255,15,17
1384,1,5,-50,-5,10
1385,1,0,-36,-6,6
1386,1,-6,-91,7,-13
1387,1,4,-45,-5,9
1388,1,-6,-72,6,-12
1389,1,18,80,10,8
1390,1,0,-9,-3,3
1391,1,5,6,3,2
1392,1,24,135,15,9
1393,1,-13,-30,2,-15
1394,1,-34,289,-17,-17
1395,1,-2,-8,-4,2
1396,1,-3,0,0,-3
1397,1,20,75,5,15
1398,1,1,0,1,0
1399,1,14,49,7,7
1400,1,-6,5,-5,-1
1401,1,7,-170,17,-10
1402,1,2,-48,-6,8
1403,1,9,-70,14,-5
1404,1,-24,95,-19,-5
1405,1,3,-28,-4,7
1406,1,21,54,18,3
1407,1,-16,48,-4,-12
1408,1,-3,-304,-19,16
1409,1,-18,0,-18,0
1410,1,19,48,16,3
1411,1,-20,91,-13,-7
1412,1,5,-66,-6,11
1413,1,32,255,15,17
1414,1,-5,-204,-17,12
1415,1,-19,88,-8,-11
1416,1,6,-112,14,-8
1417,1,20,96,12,8
1418,1,15,56,8,7
1419,1,-3,-10,-5,2
1420,1,-20,99,-11,-9
1421,1,13,40,5,8
1422,1,16,-36,18,-2
1423,1,4,-117,-9,13
1424,1,26,169,13,13
1425,1,21,90,6,15
1426,1,-8,7,-1,-7
1427,1,33,270,18,15
1428,1,22,40,20,2
1429,1,25,150,15,10
1430,1,-11,-12,-12,1
1431,1,-17,-38,-19,2
1432,1,8,-128,16,-8
1433,1,7,6,1,6
1434,1,3,-340,20,-17
1435,1,30,221,17,13
1436,1,21,68,17,4
1437,1,37,340,20,17
1438,1,6,-40,10,-4
1439,1,13,-14,-1,14
1440,1,-27,140,-7,-20
1441,1,33,266,14,19
1442,1,-1,-182,-14,13
1443,1,38,361,19,19
1444,1,-13,-114,-19,6
1445,1,14,24,2,12
1446,1,3,-304,-16,19
1447,1,34,288,16,18
1448,1,1,-42,-6,7
1449,1,14,24,12,2
1450,1,-13,22,-11,-2
1451,1,-3,2,-1,-2
1452,1,17,52,13,4
1453,1,3,-130,-10,13
1454,1,-7,-144,-16,9
1455,1,0,-324,18,-18
1456,1,-13,22,-11,-2
1457,1,-20,96,-12,-8
1458,1,0,-100,-10,10
1459,1,4,-140,14,-10
1460,1,3,-154,14,-11
1461,1,-6,-216,12,-18
1462,1,-18,0,0,-18
1463,1,-1,-156,-13,12
1464,1,-10,16,-2,-8
1465,1,-5,-104,8,-13
1466,1,-21,68,-17,-4
1467,1,6,0,6,0
1468,1,-22,120,-12,-10
1469,1,5,-66,-6,11
1470,1,-24,108,-18,-6
1471,1,-7,10,-2,-5
1472,1,-9,-36,3,-12
1473,1,15,26,2,13
1474,1,28,160,20,8
1475,1,5,4,1,4
1476,1,7,0,0,7
1477,1,30,225,15,15
1478,1,0,-4,2,-2
1479,1,9,20,4,5
1480,1,-15,-100,5,-20
1481,1,-11,30,-6,-5
1482,1,-20,36,-18,-2
1483,1,-13,0,-13,0
1484,1,10,-24,12,-2
1485,1,-20,84,-14,-6
1486,1,18,81,9,9
1487,1,4,-21,-3,7
1488,1,7,6,6,1
1489,1,-13,-90,5,-18
1490,1,4,-221,17,-13
1491,1,2,-143,13,-11
1492,1,5,-6,6,-1
1493,1,-25,144,-16,-9
1494,1,29,210,15,14
1495,1,-2,-63,-9,7
1496,1,8,12,6,2
1497,1,20,91,13,7
1498,1,0,-400,-20,20
1499,1,-27,162,-9,-18
1500,1,2,-8,4,-2
1501,1,-28,196,-14,-14
1502,1,-25,126,-7,-18
1503,1,10,9,1,9
1504,1,21,90,6,15
1505,1,35,304,16,19
1506,1,0,-289,17,-17
1507,1,10,-200,-10,20
1508,1,-5,-24,3,-8
1509,1,-33,260,-20,-13
1510,1,0,-16,4,-4
1511,1,-12,20,-2,-10
1512,1,-23,102,-6,-17
1513,1,12,-85,-5,17
1514,1,-7,-144,9,-16
1515,1,17,70,7,10
1516,1,10,-144,18,-8
1517,1,-16,-57,-19,3
1518,1,-5,-50,-10,5
1519,1,12,27,3,9
1520,1,2,-120,12,-10
1521,1,18,72,6,12
1522,1,-19,60,-15,-4
1523,1,10,-24,-2,12
1524,1,-13,0,0,-13
1525,1,-14,45,-9,-5
1526,1,-13,-114,6,-19
1527,1,-3,-270,15,-18
1528,1,-20,91,-7,-13
1529,1,9,14,2,7
1530,1,-18,-40,-20,2
1531,1,-25,136,-8,-17
1532,1,27,162,9,18
1533,1,-27,170,-10,-17
1534,1,-10,-39,3,-13
1535,1,-13,-90,-18,5
1536,1,13,40,8,5
1537,1,23,76,4,19
1538,1,-7,-30,3,-10
1539,1,-10,-144,-18,8
1540,1,6,-40,-4,10
1541,1,24,80,4,20
1542,1,-4,-252,14,-18
1543,1,22,85,17,5
1544,1,-16,15,-1,-15
1545,1,33,272,16,17
1546,1,-33,260,-20,-13
1547,1,8,-65,13,-5
1548,1,-13,36,-4,-9
1549,1,-4,-140,10,-14
1550,1,0,-100,-10,10
1551,1,-31,234,-13,-18
1552,1,6,-7,7,-1
1553,1,13,-90,18,-5
1554,1,-22,121,-11,-11
1555,1,-13,-48,-16,3
1556,1,13,42,6,7
1557,1,-31,238,-14,-17
1558,1,-16,15,-15,-1
1559,1,13,-14,14,-1
1560,1,16,-80,-4,20
1561,1,36,323,19,17
1562,1,19,34,2,17
1563,1,7,-144,-9,16
1564,1,-17,30,-2,-15
1565,1,-1,-272,16,-17
1566,1,27,170,17,10
1567,1,-21,108,-12,-9
1568,1,-14,-51,-17,3
1569,1,30,216,12,18
1570,1,33,270,15,18
1571,1,30,224,14,16
1572,1,-33,260,-20,-13
1573,1,-12,20,-2,-10
1574,1,-5,-234,-18,13
1575,1,-5,-50,5,-10
1576,1,13,-30,15,-2
1577,1,0,-121,-11,11
1578,1,4,-221,-13,17
1579,1,-26,153,-9,-17
1580,1,8,-240,-12,20
1581,1,-15,-76,4,-19
1582,1,-2,-8,2,-4
1583,1,-2,-323,17,-19
1584,1,24,144,12,12
1585,1,0,-400,-20,20
1586,1,15,26,2,13
1587,1,4,-96,-8,12
1588,1,15,-16,16,-1
1589,1,5,4,4,1
1590,1,0,-36,-6,6
1591,1,0,-4,-2,2
1592,1,-14,0,-14,0
1593,1,-22,105,-15,-7
1594,1,-10,-144,8,-18
1595,1,-18,17,-17,-1
1596,1,-8,7,-7,-1
1597,1,18,65,13,5
1598,1,-15,-76,4,-19
1599,1,4,-21,7,-3
1600,1,-12,-133,7,-19
1601,1,-15,50,-5,-10
1602,1,9,20,5,4
1603,1,-33,270,-15,-18
1604,1,6,-135,15,-9
1605,1,-31,220,-20,-11
1606,1,-11,28,-4,-7
1607,1,-9,-22,2,-11
1608,1,-5,-300,15,-20
1609,1,-20,75,-15,-5
1610,1,5,6,3,2
1611,1,8,-9,-1,9
1612,1,2,-15,5,-3
1613,1,19,88,8,11
1614,1,-17,-60,-20,3
1615,1,23,76,19,4
1616,1,9,-190,19,-10
1617,1,1,-12,4,-3
1618,1,-15,-100,5,-20
1619,1,-1,-380,19,-20
1620,1,-15,14,-14,-1
1621,1,24,128,8,16
1622,1,-23,126,-14,-9
1623,1,15,44,4,11
1624,1,6,-91,-7,13
1625,1,-13,-140,7,-20
1626,1,9,-10,10,-1
1627,1,-16,48,-12,-4
1628,1,-16,48,-4,-12
1629,1,8,-209,-11,19
1630,1,-7,-78,6,-13
1631,1,3,-130,13,-10
1632,1,22,121,11,11
1633,1,-19,84,-7,-12
1634,1,17,-18,18,-1
1635,1,-30,216,-12,-18
1636,1,-17,0,0,-17
1637,1,3,-130,-10,13
1638,1,2,0,2,0
1639,1,-1,-156,-13,12
1640,1,-4,-165,-15,11
1641,1,-4,-32,4,-8
1642,1,-11,-42,-14,3
1643,1,2,-3,3,-1
1644,1,13,-30,-2,15
1645,1,-18,80,-8,-10
1646,1,4,-320,20,-16
1647,1,-18,-19,-19,1
1648,1,-10,-11,1,-11
1649,1,19,90,10,9
1650,1,-9,14,-2,-7
1651,1,-14,-15,-15,1
1652,1,1,-156,13,-12
1653,1,1,-42,-6,7
1654,1,32,252,18,14
1655,1,-4,-60,-10,6
1656,1,-8,0,-8,0
1657,1,35,300,15,20
1658,1,-9,-190,10,-19
1659,1,13,-90,-5,18
1660,1,-7,-30,3,-10
1661,1,-15,50,-10,-5
1662,1,9,-22,11,-2
1663,1,5,-176,16,-11
1664,1,-22,105,-15,-7
1665,1,26,169,13,13
1666,1,3,-28,-4,7
1667,1,16,64,8,8
1668,1,6,-72,12,-6
1669,1,-31,234,-13,-18
1670,1,-16,-80,4,-20
1671,1,-23,120,-15,-8
1672,1,24,140,10,14
1673,1,-17,52,-4,-13
1674,1,-28,160,-20,-8
1675,1,14,40,10,4
1676,1,22,57,19,3
1677,1,0,-25,5,-5
1678,1,-6,-187,-17,11
1679,1,-10,21,-7,-3
1680,1,-29,198,-18,-11
1681,1,13,-68,17,-4
1682,1,5,-234,-13,18
1683,1,-13,-68,4,-17
1684,1,22,117,9,13
1685,1,-2,-323,-19,17
1686,1,-5,-50,5,-10
1687,1,-5,-84,-12,7
1688,1,5,-6,6,-1
1689,1,24,128,8,16
1690,1,8,-180,-10,18
1691,1,18,32,16,2
1692,1,-15,56,-7,-8
1693,1,19,-20,20,-1
1694,1,-18,56,-14,-4
1695,1,14,-95,-5,19
1696,1,10,-200,-10,20
1697,1,-16,-17,1,-17
1698,1,6,-112,-8,14
1699,1,-7,-44,-11,4
1700,1,-14,33,-11,-3
1701,1,-6,-72,-12,6
1702,1,22,112,8,14
1703,1,-12,0,-12,0
1704,1,7,-228,-12,19
1705,1,24,80,20,4
1706,1,17,42,14,3
1707,1,-11,30,-5,-6
1708,1,1,-42,-6,7
1709,1,34,288,18,16
1710,1,27,180,15,12
1711,1,-19,60,-15,-4
1712,1,24,80,20,4
1713,1,15,-16,16,-1
1714,1,15,0,15,0
1715,1,-7,-44,-11,4
1716,1,-18,80,-8,-10
1717,1,23,102,6,17
1718,1,-5,-84,7,-12
1719,1,-33,270,-15,-18
1720,1,-11,-42,3,-14
1721,1,28,160,20,8
1722,1,1,-12,4,-3
1723,1,-10,-11,1,-11
1724,1,23,112,16,7
1725,1,31,238,17,14
1726,1,8,-209,19,-11
1727,1,5,-36,-4,9
1728,1,-36,320,-16,-20
1729,1,-2,-8,2,-4
1730,1,27,180,12,15
1731,1,-19,78,-13,-6
1732,1,16,15,1,15
1733,1,15,36,12,3
1734,1,8,-65,13,-5
1735,1,-3,-18,3,-6
1736,1,11,10,1,10
1737,1,14,-15,-1,15
1738,1,10,9,9,1
1739,1,-3,-304,-19,16
1740,1,-11,28,-7,-4
1741,1,19,84,12,7
1742,1,-11,30,-6,-5
1743,1,-27,182,-13,-14
1744,1,1,-306,-17,18
1745,1,19,34,17,2
1746,1,-20,0,0,-20
1747,1,-26,120,-20,-6
1748,1,14,48,6,8
1749,1,-13,-68,4,-17
1750,1,-8,-209,11,-19
1751,1,25,144,9,16
1752,1,-21,108,-12,-9
1753,1,-6,-55,5,-11
1754,1,34,289,17,17
1755,1,23,112,16,7
1756,1,2,-168,-12,14
1757,1,-16,60,-6,-10
1758,1,-8,15,-5,-3
1759,1,-25,136,-17,-8
1760,1,-10,25,-5,-5
1761,1,-33,270,-18,-15
1762,1,-10,-200,-20,10
1763,1,5,-24,8,-3
1764,1,12,35,5,7
1765,1,-14,24,-12,-2
1766,1,-11,10,-10,-1
1767,1,-9,-36,3,-12
1768,1,1,-6,3,-2
1769,1,-8,-105,7,-15
1770,1,-14,-15,-15,1
1771,1,-30,209,-11,-19
1772,1,-12,11,-1,-11
1773,1,17,-18,-1,18
1774,1,13,22,2,11
1775,1,15,0,15,0
1776,1,-1,-72,-9,8
1777,1,19,84,7,12
1778,1,-11,-102,-17,6
1779,1,23,60,20,3
1780,1,0,-9,3,-3
1781,1,19,18,1,18
1782,1,-23,60,-3,-20
1783,1,11,-180,20,-9
1784,1,13,-140,-7,20
1785,1,-17,16,-1,-16
1786,1,15,50,10,5
1787,1,23,132,12,11
1788,1,0,-4,-2,2
1789,1,-30,216,-18,-12
1790,1,-17,0,0,-17
1791,1,-1,-56,7,-8
1792,1,-17,-18,1,-18
1793,1,-5,0,0,-5
1794,1,-14,-15,-15,1
1795,1,13,22,2,11
1796,1,27,182,13,14
1797,1,-10,-75,5,-15
1798,1,3,-40,-5,8
1799,1,-8,-65,5,-13
1800,1,2,-288,-16,18
1801,1,13,-114,-6,19
1802,1,-4,-252,-18,14
1803,1,-12,-13,1,-13
1804,1,15,36,12,3
1805,1,12,0,12,0
1806,1,-30,224,-16,-14
1807,1,-22,72,-4,-18
1808,1,12,-85,-5,17
1809,1,-7,-228,-19,12
1810,1,20,51,3,17
1811,1,14,-120,-6,20
1812,1,-38,361,-19,-19
1813,1,-6,-16,-8,2
1814,1,-26,169,-13,-13
1815,1,-24,95,-5,-19
1816,1,-13,22,-2,-11
1817,1,29,208,13,16
1818,1,-1,0,0,-1
1819,1,-24,128,-8,-16
1820,1,21,90,6,15
1821,1,7,-30,10,-3
1822,1,-29,210,-14,-15
1823,1,-11,-126,7,-18
1824,1,15,-34,17,-2
1825,1,35,306,18,17
1826,1,7,-144,-9,16
1827,1,10,21,7,3
1828,1,-3,-88,-11,8
1829,1,8,-33,-3,11
1830,1,25,114,19,6
1831,1,-16,60,-6,-10
1832,1,10,-96,16,-6
1833,1,7,-60,12,-5
1834,1,1,-210,15,-14
1835,1,12,36,6,6
1836,1,12,35,7,5
1837,1,-3,-154,11,-14
1838,1,1,-132,12,-11
1839,1,12,27,9,3
1840,1,15,-100,-5,20
1841,1,-4,-77,-11,7
1842,1,-21,80,-5,-16
1843,1,-9,8,-1,-8
1844,1,3,-18,6,-3
1845,1,-2,-120,10,-12
1846,1,2,-3,-1,3
1847,1,3,-154,14,-11
1848,1,-14,-95,5,-19
1849,1,37,340,20,17
1850,1,-3,-40,5,-8
1851,1,-23,76,-4,-19
1852,1,-15,0,0,-15
1853,1,25,150,10,15
1854,1,24,144,12,12
1855,1,-27,140,-20,-7
1856,1,10,-119,-7,17
1857,1,7,-98,-7,14
1858,1,8,-153,17,-9
1859,1,6,-55,11,-5
1860,1,-39,380,-20,-19
1861,1,-20,99,-11,-9
1862,1,-3,-238,14,-17
1863,1,7,0,0,7
1864,1,-15,0,-15,0
1865,1,11,30,6,5
1866,1,-12,32,-4,-8
1867,1,0,-324,18,-18
1868,1,-17,0,0,-17
1869,1,12,35,5,7
1870,1,-12,0,-12,0
1871,1,0,-4,-2,2
1872,1,5,-36,-4,9
1873,1,-3,-340,17,-20
1874,1,12,11,11,1
1875,1,1,-182,14,-13
1876,1,-12,11,-1,-11
1877,1,-5,-234,13,-18
1878,1,-16,-80,-20,4
1879,1,12,-45,15,-3
1880,1,8,-33,11,-3
1881,1,0,-121,-11,11
1882,1,-5,-126,-14,9
1883,1,12,20,2,10
1884,1,33,260,20,13
1885,1,1,-2,-1,2
1886,1,26,168,12,14
1887,1,16,-80,-4,20
1888,1,14,24,12,2
1889,1,-13,-30,2,-15
1890,1,-35,304,-16,-19
1891,1,-7,-170,10,-17
1892,1,-5,4,-4,-1
1893,1,31,234,18,13
1894,1,-17,30,-15,-2
1895,1,-12,-160,8,-20
1896,1,-12,-108,6,-18
1897,1,-31,238,-14,-17
1898,1,-25,136,-8,-17
1899,1,-8,-65,5,-13
1900,1,-19,34,-17,-2
1901,1,9,-162,18,-9
1902,1,-1,-42,6,-7
1903,1,-25,154,-14,-11
1904,1,-7,-228,-19,12
1905,1,23,130,13,10
1906,1,-8,-180,10,-18
1907,1,-5,-66,-11,6
1908,1,-15,-16,1,-16
1909,1,34,288,16,18
1910,1,-24,140,-14,-10
1911,1,7,-98,14,-7
1912,1,-21,68,-17,-4
1913,1,1,-6,-2,3
1914,1,33,270,18,15
1915,1,13,36,4,9
1916,1,-18,72,-6,-12
1917,1,-5,-104,-13,8
1918,1,18,77,11,7
1919,1,-18,80,-10,-8
1920,1,6,-247,-13,19
1921,1,14,48,8,6
1922,1,-10,-171,-19,9
1923,1,5,-104,-8,13
1924,1,11,-180,20,-9
1925,1,38,361,19,19
1926,1,-4,-285,-19,15
1927,1,12,-108,18,-6
1928,1,15,36,3,12
1929,1,-13,-114,6,-19
1930,1,11,10,1,10
1931,1,-37,340,-17,-20
1932,1,21,20,20,1
1933,1,11,28,4,7
1934,1,-2,-63,-9,7
1935,1,2,-80,10,-8
1936,1,-1,-210,14,-15
1937,1,18,45,3,15
1938,1,-30,224,-16,-14
1939,1,2,-255,17,-15
1940,1,5,-176,-11,16
1941,1,13,-68,-4,17
1942,1,3,-70,10,-7
1943,1,6,-280,20,-14
1944,1,11,-12,12,-1
1945,1,-22,72,-18,-4
1946,1,-24,95,-19,-5
1947,1,-26,120,-6,-20
1948,1,19,60,4,15
1949,1,8,-153,-9,17
1950,1,-6,-16,-8,2
1951,1,-25,144,-9,-16
1952,1,-7,-60,5,-12
1953,1,-10,-119,7,-17
1954,1,21,90,6,15
1955,1,1,0,1,0
1956,1,-11,-152,-19,8
1957,1,24,119,7,17
1958,1,-25,114,-6,-19
1959,1,-16,-57,-19,3
1960,1,9,14,2,7
1961,1,-11,0,-11,0
1962,1,7,-44,11,-4
1963,1,14,48,8,6
1964,1,1,-90,10,-9
1965,1,-16,55,-5,-11
1966,1,-20,91,-13,-7
1967,1,9,-112,-7,16
1968,1,7,-228,-12,19
1969,1,-5,0,0,-5
1970,1,-29,180,-9,-20
1971,1,18,-19,-1,19
1972,1,24,128,16,8
1973,1,-7,-144,-16,9
1974,1,-27,182,-14,-13
1975,1,14,-51,17,-3
1976,1,2,-8,-2,4
1977,1,3,-40,8,-5
1978,1,26,144,18,8
1979,1,-15,-34,-17,2
1980,1,-18,65,-13,-5
1981,1,-31,234,-13,-18
1982,1,6,-55,-5,11
1983,1,1,-156,13,-12
1984,1,12,-28,-2,14
1985,1,-13,12,-1,-12
1986,1,24,140,10,14
1987,1,8,-180,-10,18
1988,1,-1,-240,-16,15
1989,1,-6,-160,10,-16
1990,1,25,136,17,8
1991,1,20,75,15,5
1992,1,-16,-57,-19,3
1993,1,17,70,10,7
1994,1,29,210,15,14
1995,1,-37,342,-18,-19
1996,1,-5,-104,8,-13
1997,1,3,-4,-1,4
1998,1,-15,-76,-19,4
1999,1,-4,-192,12,-16
2000,1,19,90,10,9
2001,1,16,-80,20,-4
2002,1,18,72,6,12
2003,1,-17,0,0,-17
2004,1,-32,240,-20,-12
2005,1,-24,128,-8,-16
2006,1,-9,-162,9,-18
2007,1,6,-91,-7,13
2008,1,2,-99,-9,11
2009,1,15,14,14,1
2010,1,14,13,1,13
2011,1,2,-255,17,-15
2012,1,3,-208,-13,16
2013,1,13,-114,-6,19
2014,1,-13,-68,4,-17
2015,1,-3,-18,-6,3
2016,1,2,-168,-12,14
2017,1,8,-9,-1,9
2018,1,6,8,2,4
2019,1,15,-34,17,-2
2020,1,-21,98,-14,-7
2021,1,9,-90,-6,15
2022,1,3,-88,11,-8
2023,1,0,-36,-6,6
2024,1,-6,8,-2,-4
2025,1,-13,30,-10,-3
2026,1,-1,-210,-15,14
2027,1,1,-210,-14,15
2028,1,-7,10,-5,-2
2029,1,-13,-48,3,-16
2030,1,-9,18,-3,-6
2031,1,-10,-39,3,-13
2032,1,-17,42,-14,-3
2033,1,6,-27,9,-3
2034,1,-18,65,-13,-5
2035,1,6,-16,-2,8
2036,1,21,20,1,20
2037,1,-3,-208,13,-16
2038,1,17,60,5,12
2039,1,23,130,13,10
2040,1,-1,-2,-2,1
2041,1,20,96,12,8
2042,1,11,-180,-9,20
2043,1,-1,-56,7,-8
2044,1,-29,190,-10,-19
2045,1,-10,-56,-14,4
2046,1,-12,36,-6,-6
2047,1,22,57,3,19
2048,1,-27,176,-16,-11
2049,1,20,19,19,1
2050,1,-18,65,-13,-5
2051,1,7,-228,19,-12
2052,1,-6,-247,-19,13
2053,1,38,360,20,18
2054,1,12,32,8,4
2055,1,-11,-126,7,-18
2056,1,-18,77,-11,-7
2057,1,-1,-12,3,-4
2058,1,-1,-20,-5,4
2059,1,1,-90,10,-9
2060,1,-3,-28,-7,4
2061,1,-3,0,0,-3
2062,1,20,0,0,20
2063,1,-16,0,-16,0
2064,1,-31,240,-16,-15
2065,1,28,180,18,10
2066,1,8,-209,19,-11
2067,1,-10,-200,10,-20
2068,1,9,0,9,0
2069,1,-7,10,-5,-2
2070,1,-12,-133,-19,7
2071,1,-29,208,-13,-16
2072,1,-14,45,-5,-9
2073,1,19,18,18,1
2074,1,5,-150,-10,15
2075,1,18,77,7,11
2076,1,-15,-34,2,-17
2077,1,-9,-10,-10,1
2078,1,-5,-234,-18,13
2079,1,-4,4,-2,-2
2080,1,25,136,8,17
2081,1,-3,-130,10,-13
2082,1,36,320,20,16
2083,1,14,33,3,11
2084,1,-19,48,-16,-3
2085,1,-11,18,-9,-2
2086,1,37,340,17,20
2087,1,-13,0,-13,0
2088,1,28,195,13,15
2089,1,9,-22,11,-2
2090,1,-31,228,-19,-12
2091,1,21,20,1,20
2092,1,-2,-288,16,-18
2093,1,10,-24,-2,12
2094,1,-1,-132,11,-12
2095,1,-4,-221,13,-17
2096,1,-2,-80,8,-10
2097,1,-21,54,-3,-18
2098,1,10,24,4,6
2099,1,-34,285,-19,-15
2100,1,-2,-3,1,-3
2101,1,-3,-304,16,-19
2102,1,-34,285,-19,-15
2103,1,-9,-70,-14,5
2104,1,-8,-65,-13,5
2105,1,-8,-105,7,-15
2106,1,3,-10,-2,5
2107,1,1,-30,-5,6
2108,1,13,30,10,3
2109,1,-5,-204,-17,12
2110,1,-5,-24,-8,3
2111,1,2,0,2,0
2112,1,27,162,9,18
2113,1,-13,40,-5,-8
2114,1,-18,-19,-19,1
2115,1,-4,-12,2,-6
2116,1,13,-68,-4,17
2117,1,-9,-36,-12,3
2118,1,-27,180,-12,-15
2119,1,16,63,9,7
2120,1,25,126,7,18
2121,1,24,119,7,17
2122,1,-22,85,-17,-5
2123,1,18,32,16,2
2124,1,4,0,0,4
2125,1,-14,-95,-19,5
2126,1,12,35,5,7
2127,1,-28,180,-10,-18
2128,1,21,90,6,15
2129,1,-11,28,-7,-4
2130,1,-7,-170,10,-17
2131,1,-13,12,-1,-12
2132,1,11,-102,17,-6
2133,1,5,-126,-9,14
2134,1,-25,154,-11,-14
2135,1,2,-323,19,-17
2136,1,2,-288,-16,18
2137,1,-14,40,-4,-10
2138,1,6,-40,-4,10
2139,1,-13,40,-5,-8
2140,1,11,10,10,1
2141,1,-15,56,-8,-7
2142,1,13,42,7,6
2143,1,6,0,0,6
2144,1,-9,-10,-10,1
2145,1,6,-27,-3,9
2146,1,-30,224,-16,-14
2147,1,7,-170,17,-10
2148,1,3,0,0,3
2149,1,25,144,9,16
2150,1,-12,-160,-20,8
2151,1,9,-136,-8,17
2152,1,16,28,14,2
2153,1,5,-36,9,-4
2154,1,-16,-80,4,-20
2155,1,-3,-70,7,-10
2156,1,-8,12,-6,-2
2157,1,-28,196,-14,-14
2158,1,-34,289,-17,-17
2159,1,18,56,14,4
2160,1,6,-40,-4,10
2161,1,18,77,11,7
2162,1,-9,-190,-19,10
2163,1,18,-19,-1,19
2164,1,-5,-66,6,-11
2165,1,-1,-42,-7,6
2166,1,-23,76,-19,-4
2167,1,-1,-240,-16,15
2168,1,-7,-144,9,-16
2169,1,-10,-75,-15,5
2170,1,-15,-76,-19,4
2171,1,1,-56,8,-7
2172,1,1,-2,-1,2
2173,1,-10,-119,7,-17
2174,1,-24,135,-15,-9
2175,1,-2,-8,-4,2
2176,1,15,-54,-3,18
2177,1,-19,60,-4,-15
2178,1,5,0,0,5
2179,1,1,-12,4,-3
2180,1,-7,6,-6,-1
2181,1,-23,90,-18,-5
2182,1,-21,20,-20,-1
2183,1,-21,54,-18,-3
2184,1,-12,-13,-13,1
2185,1,10,21,7,3
2186,1,-12,0,-12,0
2187,1,-13,-14,1,-14
2188,1,-30,216,-12,-18
2189,1,-20,96,-12,-8
2190,1,-17,70,-10,-7
2191,1,-9,-22,2,-11
2192,1,-12,11,-1,-11
2193,1,3,-154,14,-11
2194,1,6,-16,8,-2
2195,1,11,-80,16,-5
2196,1,-1,-30,-6,5
2197,1,-23,130,-10,-13
2198,1,-1,-380,19,-20
2199,1,31,238,14,17
2200,1,-16,39,-3,-13
2201,1,-22,105,-7,-15
2202,1,0,-81,-9,9
2203,1,-6,0,0,-6
2204,1,3,-154,14,-11
2205,1,-9,-136,8,-17
2206,1,11,-180,-9,20
2207,1,16,63,7,9
2208,1,8,-48,12,-4
2209,1,11,28,4,7
2210,1,-3,-108,9,-12
2211,1,-4,-96,8,-12
2212,1,17,30,2,15
2213,1,13,42,6,7
2214,1,-8,-105,-15,7
2215,1,-32,240,-20,-12
2216,1,2,-168,-12,14
2217,1,-19,18,-18,-1
2218,1,0,-144,-12,12
2219,1,-15,14,-14,-1
2220,1,-15,14,-14,-1
2221,1,23,90,5,18
2222,1,16,-36,18,-2
2223,1,-5,4,-1,-4
2224,1,-24,144,-12,-12
2225,1,10,-75,15,-5
2226,1,-22,105,-7,-15
2227,1,-4,-5,1,-5
2228,1,22,117,13,9
2229,1,1,-110,-10,11
2230,1,-30,200,-20,-10
2231,1,-3,-40,-8,5
2232,1,-32,252,-18,-14
2233,1,-5,-104,-13,8
2234,1,-7,-260,13,-20
2235,1,-11,10,-1,-10
2236,1,0,-16,4,-4
2237,1,-11,0,0,-11
2238,1,-12,-85,5,-17
2239,1,22,96,6,16
2240,1,9,-10,-1,10
2241,1,3,-18,-3,6
2242,1,4,0,0,4
2243,1,-19,60,-4,-15
2244,1,4,-140,14,-10
2245,1,12,27,3,9
2246,1,-22,117,-9,-13
2247,1,5,-14,-2,7
2248,1,16,-17,17,-1
2249,1,2,-35,7,-5
2250,1,12,11,1,11
2251,1,-10,-24,-12,2
2252,1,-1,-380,19,-20
2253,1,2,-3,3,-1
2254,1,13,40,8,5
2255,1,-34,280,-14,-20
2256,1,-11,-12,1,-12
2257,1,-17,42,-14,-3
2258,1,-7,-260,-20,13
2259,1,12,11,1,11
2260,1,10,16,2,8
2261,1,-6,-27,3,-9
2262,1,21,68,17,4
2263,1,-3,-154,11,-14
2264,1,-11,-180,9,-20
2265,1,-4,-12,2,-6
2266,1,8,12,6,2
2267,1,30,200,10,20
2268,1,21,110,10,11
2269,1,-19,84,-12,-7
2270,1,4,-77,11,-7
2271,1,13,-48,16,-3
2272,1,-26,153,-9,-17
2273,1,-16,55,-5,-11
2274,1,-19,18,-18,-1
2275,1,18,72,6,12
2276,1,18,72,12,6
2277,1,-13,-30,2,-15
2278,1,-12,20,-2,-10
2279,1,-32,256,-16,-16
2280,1,-32,255,-17,-15
2281,1,-7,-144,-16,9
2282,1,-22,117,-9,-13
2283,1,9,-190,-10,19
2284,1,0,-9,3,-3
2285,1,4,-12,-2,6
2286,1,8,-84,14,-6
2287,1,-26,120,-6,-20
2288,1,2,-288,-16,18
2289,1,-11,24,-3,-8
2290,1,-8,-105,-15,7
2291,1,-19,18,-18,-1
2292,1,-12,-85,-17,5
2293,1,5,-50,10,-5
2294,1,-9,-112,-16,7
2295,1,-2,-360,-20,18
2296,1,21,110,10,11
2297,1,20,99,11,9
2298,1,11,18,2,9
2299,1,-16,-80,4,-20
2300,1,1,-42,-6,7
2301,1,27,180,12,15
2302,1,0,-324,18,-18
2303,1,-2,-63,7,-9
2304,1,-2,-3,1,-3
2305,1,-19,70,-14,-5
2306,1,0,-225,-15,15
2307,1,6,-247,-13,19
2308,1,-4,-12,2,-6
2309,1,7,-228,-12,19
2310,1,-31,234,-18,-13
2311,1,20,19,1,19
2312,1,-7,-120,-15,8
2313,1,-7,-44,4,-11
2314,1,-11,24,-3,-8
2315,1,23,90,5,18
2316,1,20,91,13,7
2317,1,-26,165,-11,-15
2318,1,34,285,19,15
2319,1,-1,-156,-13,12
2320,1,-28,171,-9,-19
2321,1,-5,6,-2,-3
2322,1,-3,-180,-15,12
2323,1,18,-40,20,-2
2324,1,-12,32,-8,-4
2325,1,-29,180,-20,-9
2326,1,24,108,18,6
2327,1,26,133,7,19
2328,1,16,-36,-2,18
2329,1,2,-63,-7,9
2330,1,-12,-28,-14,2
2331,1,9,-136,17,-8
2332,1,17,-60,-3,20
2333,1,26,165,15,11
2334,1,21,68,4,17
2335,1,11,-152,19,-8
2336,1,-4,-45,-9,5
2337,1,-12,-85,5,-17
2338,1,-12,20,-10,-2
2339,1,25,100,5,20
2340,1,-8,-20,2,-10
2341,1,28,171,9,19
2342,1,-4,-12,-6,2
2343,1,-13,42,-6,-7
2344,1,6,-112,14,-8
2345,1,-2,-288,-18,16
2346,1,30,221,17,13
2347,1,-33,272,-16,-17
2348,1,-33,266,-19,-14
2349,1,-2,-224,14,-16
2350,1,-24,95,-5,-19
2351,1,9,0,9,0
2352,1,17,66,6,11
2353,1,0,-361,19,-19
2354,1,-21,90,-6,-15
2355,1,-13,36,-9,-4
2356,1,-4,-117,-13,9
2357,1,3,-70,10,-7
2358,1,-16,-36,2,-18
2359,1,-4,-165,-15,11
2360,1,-6,-160,10,-16
2361,1,1,-306,-17,18
2362,1,-28,180,-18,-10
2363,1,-6,-7,1,-7
2364,1,-8,-128,-16,8
2365,1,21,68,17,4
2366,1,-19,60,-15,-4
2367,1,2,-8,-2,4
2368,1,-3,-208,13,-16
2369,1,21,68,4,17
2370,1,-1,-132,-12,11
2371,1,-24,140,-10,-14
2372,1,-14,45,-5,-9
2373,1,9,-190,19,-10
2374,1,5,-234,18,-13
2375,1,6,-72,12,-6
2376,1,10,-39,13,-3
2377,1,19,18,18,1
2378,1,21,38,19,2
2379,1,28,171,19,9
2380,1,-4,4,-2,-2
2381,1,-21,110,-10,-11
2382,1,38,360,18,20
2383,1,-11,10,-10,-1
2384,1,13,36,4,9
2385,1,-9,-162,-18,9
2386,1,3,-270,-15,18
2387,1,14,40,4,10
2388,1,-14,45,-5,-9
2389,1,-24,140,-10,-14
2390,1,5,-150,-10,15
2391,1,10,-75,15,-5
2392,1,-8,-33,3,-11
2393,1,-1,-12,3,-4
2394,1,-12,-108,6,-18
2395,1,-24,144,-12,-12
2396,1,19,84,12,7
2397,1,1,-72,-8,9
2398,1,-10,-200,-20,10
2399,1,13,30,10,3
2400,1,12,36,6,6
2401,1,1,0,0,1
2402,1,9,-36,-3,12
2403,1,-6,-16,-8,2
2404,1,-2,-360,-20,18
2405,1,34,288,18,16
2406,1,35,300,20,15
2407,1,-1,-182,-14,13
2408,1,12,32,8,4
2409,1,10,-75,-5,15
2410,1,-4,-60,-10,6
2411,1,11,24,8,3
2412,1,12,36,6,6
2413,1,-10,-119,-17,7
2414,1,25,150,10,15
2415,1,-16,63,-7,-9
2416,1,10,-144,-8,18
2417,1,-13,-48,3,-16
2418,1,-19,78,-13,-6
2419,1,-7,6,-6,-1
2420,1,32,247,13,19
2421,1,-21,104,-13,-8
2422,1,5,6,3,2
2423,1,19,60,4,15
2424,1,20,91,7,13
2425,1,7,-120,15,-8
2426,1,1,-156,13,-12
2427,1,-27,162,-18,-9
2428,1,15,-54,-3,18
2429,1,0,-9,-3,3
2430,1,-12,-13,1,-13
2431,1,9,-220,20,-11
2432,1,0,-100,10,-10
2433,1,-1,0,-1,0
2434,1,-4,3,-3,-1
2435,1,-20,51,-17,-3
2436,1,3,-54,9,-6
2437,1,2,-99,11,-9
2438,1,-22,117,-9,-13
2439,1,-14,24,-12,-2
2440,1,-9,-22,2,-11
2441,1,-12,-133,7,-19
2442,1,3,-10,-2,5
2443,1,-3,-340,-20,17
2444,1,-10,0,0,-10
2445,1,3,-40,-5,8
2446,1,-6,-40,-10,4
2447,1,-2,-99,9,-11
2448,1,-9,8,-1,-8
2449,1,17,42,14,3
2450,1,1,-72,-8,9
2451,1,0,-169,13,-13
2452,1,-23,76,-4,-19
2453,1,11,0,0,11
2454,1,-1,-90,9,-10
2455,1,-22,117,-13,-9
2456,1,1,-110,11,-10
2457,1,6,0,0,6
2458,1,31,228,19,12
2459,1,-8,15,-3,-5
2460,1,7,12,3,4
2461,1,22,40,2,20
2462,1,17,16,1,16
2463,1,38,360,18,20
2464,1,4,-12,6,-2
2465,1,21,20,20,1
2466,1,-5,4,-4,-1
2467,1,-24,119,-17,-7
2468,1,-21,68,-4,-17
2469,1,15,-16,-1,16
2470,1,-7,10,-2,-5
2471,1,8,-105,15,-7
2472,1,21,54,3,18
2473,1,0,-144,-12,12
2474,1,-4,-77,7,-11
2475,1,3,-28,7,-4
2476,1,-4,-320,-20,16
2477,1,-16,-17,1,-17
2478,1,-28,196,-14,-14
2479,1,11,-126,18,-7
2480,1,0,-16,-4,4
2481,1,11,-126,18,-7
2482,1,-28,187,-17,-11
2483,1,-7,-260,-20,13
2484,1,-12,-45,3,-15
2485,1,-21,20,-1,-20
2486,1,18,17,17,1
2487,1,-15,36,-12,-3
2488,1,1,-132,-11,12
2489,1,34,285,15,19
2490,1,26,120,20,6
2491,1,10,21,7,3
2492,1,2,-8,-2,4
2493,1,-11,18,-2,-9
2494,1,-7,-30,-10,3
2495,1,34,288,18,16
2496,1,-5,-266,14,-19
2497,1,-26,153,-17,-9
2498,1,-24,140,-14,-10
2499,1,21,108,9,12
2500,1,20,96,12,8
2501,1,-17,16,-16,-1
2502,1,-15,26,-13,-2
2503,1,-8,-20,-10,2
2504,1,-7,-60,5,-12
2505,1,21,98,7,14
2506,1,-34,280,-14,-20
2507,1,-29,210,-14,-15
2508,1,1,-2,2,-1
2509,1,-6,-7,-7,1
2510,1,-30,200,-20,-10
2511,1,32,255,17,15
2512,1,7,-144,-9,16
2513,1,-19,0,0,-19
2514,1,-13,-90,-18,5
2515,1,-36,323,-19,-17
2516,1,-30,221,-13,-17
2517,1,16,39,3,13
2518,1,13,30,10,3
2519,1,-27,162,-18,-9
2520,1,3,-238,-14,17
2521,1,-13,40,-5,-8
2522,1,17,30,2,15
2523,1,19,84,12,7
2524,1,15,54,9,6
2525,1,11,-26,13,-2
2526,1,-21,90,-15,-6
2527,1,-4,-60,-10,6
2528,1,6,8,4,2
2529,1,3,-54,-6,9
2530,1,-12,-64,-16,4
2531,1,-11,30,-6,-5
2532,1,20,51,3,17
2533,1,-26,160,-10,-16
2534,1,13,-68,-4,17
2535,1,15,-54,-3,18
2536,1,5,-50,10,-5
2537,1,13,-140,20,-7
2538,1,24,119,17,7
2539,1,-11,-126,-18,7
2540,1,-8,-65,5,-13
2541,1,-5,6,-2,-3
2542,1,8,-105,15,-7
2543,1,-21,38,-19,-2
2544,1,-25,154,-14,-11
2545,1,1,-182,14,-13
2546,1,-21,110,-11,-10
2547,1,-7,12,-3,-4
2548,1,-6,5,-5,-1
2549,1,-6,-16,2,-8
2550,1,-32,240,-12,-20
2551,1,6,5,1,5
2552,1,-11,-12,-12,1
2553,1,8,-84,14,-6
2554,1,-3,-108,-12,9
2555,1,-14,-51,-17,3
2556,1,12,-85,17,-5
2557,1,34,285,15,19
2558,1,-14,-95,5,-19
2559,1,-36,323,-17,-19
2560,1,17,16,16,1
2561,1,-4,-252,14,-18
2562,1,17,60,12,5
2563,1,-1,-156,-13,12
2564,1,15,-54,-3,18
2565,1,0,-361,19,-19
2566,1,0,-256,16,-16
2567,1,0,-324,-18,18
2568,1,3,-18,6,-3
2569,1,3,-154,-11,14
2570,1,31,240,15,16
2571,1,-30,224,-14,-16
2572,1,17,-18,18,-1
2573,1,-4,-165,-15,11
2574,1,14,33,3,11
2575,1,-7,-170,10,-17
2576,1,7,-98,14,-7
2577,1,32,256,16,16
2578,1,-28,195,-15,-13
2579,1,10,9,9,1
2580,1,2,0,2,0
2581,1,-9,-90,-15,6
2582,1,17,-18,-1,18
2583,1,-15,56,-8,-7
2584,1,-14,13,-1,-13
2585,1,4,-21,7,-3
2586,1,-23,76,-4,-19
2587,1,3,0,0,3
2588,1,-7,-18,2,-9
2589,1,11,0,11,0
2590,1,-12,20,-2,-10
2591,1,9,-36,-3,12
2592,1,3,-154,14,-11
2593,1,-14,49,-7,-7
2594,1,9,-112,-7,16
2595,1,0,-144,12,-12
2596,1,-9,-10,-10,1
2597,1,-3,-340,17,-20
2598,1,-29,210,-15,-14
2599,1,-3,-304,-19,16
2600,1,23,120,8,15
2601,1,-22,72,-4,-18
2602,1,-3,-40,-8,5
2603,1,15,-76,-4,19
2604,1,18,56,4,14
2605,1,-4,-12,-6,2
2606,1,1,-56,-7,8
2607,1,-4,-192,12,-16
2608,1,-2,-120,-12,10
2609,1,-11,-126,7,-18
2610,1,8,-9,-1,9
2611,1,-16,39,-13,-3
2612,1,-10,-144,-18,8
2613,1,17,66,11,6
2614,1,-16,39,-13,-3
2615,1,0,-400,20,-20
2616,1,-13,0,-13,0
2617,1,11,-80,16,-5
2618,1,-18,0,0,-18
2619,1,20,84,6,14
2620,1,-1,-20,4,-5
2621,1,-16,60,-6,-10
2622,1,10,25,5,5
2623,1,-1,-240,-16,15
2624,1,0,-16,-4,4
2625,1,4,-192,16,-12
2626,1,3,-270,18,-15
2627,1,0,-225,-15,15
2628,1,-7,-60,5,-12
2629,1,28,196,14,14
2630,1,2,-360,-18,20
2631,1,2,-168,14,-12
2632,1,20,84,6,14
2633,1,-14,-72,-18,4
2634,1,-34,285,-15,-19
2635,1,-18,56,-4,-14
2636,1,19,78,13,6
2637,1,1,-20,-4,5
2638,1,-5,-24,3,-8
2639,1,36,323,17,19
2640,1,-4,-221,13,-17
2641,1,8,-209,19,-11
2642,1,-11,-102,6,-17
2643,1,18,56,14,4
2644,1,10,-144,-8,18
2645,1,1,-182,14,-13
2646,1,24,140,10,14
2647,1,18,65,13,5
2648,1,16,39,3,13
2649,1,-13,30,-3,-10
2650,1,-10,-200,-20,10
2651,1,25,126,7,18
2652,1,-9,-70,5,-14
2653,1,-7,-78,6,-13
2654,1,-5,-50,5,-10
2655,1,0,-256,-16,16
2656,1,-4,0,0,-4
2657,1,2,-35,7,-5
2658,1,-12,-160,-20,8
2659,1,4,-140,14,-10
2660,1,25,144,9,16
2661,1,-22,112,-8,-14
2662,1,-22,40,-20,-2
2663,1,27,152,8,19
2664,1,-14,48,-8,-6
2665,1,10,-144,-8,18
2666,1,-12,-133,7,-19
2667,1,3,-28,7,-4
2668,1,9,-52,-4,13
2669,1,-20,0,0,-20
2670,1,-7,-198,11,-18
2671,1,-27,162,-18,-9
2672,1,-1,-342,-19,18
2673,1,-17,30,-15,-2
2674,1,-2,-288,16,-18
2675,1,-5,-176,11,-16
2676,1,4,-117,-9,13
2677,1,4,-77,-7,11
2678,1,16,0,0,16
2679,1,-10,-75,-15,5
2680,1,-15,-34,2,-17
2681,1,11,-26,13,-2
2682,1,-4,-252,-18,14
2683,1,3,-238,17,-14
2684,1,14,40,4,10
2685,1,25,154,14,11
2686,1,-3,-130,10,-13
2687,1,-8,-105,7,-15
2688,1,-5,4,-1,-4
2689,1,-5,-176,-16,11
2690,1,2,0,0,2
2691,1,22,105,7,15
2692,1,-13,36,-4,-9
2693,1,-4,-12,2,-6
2694,1,-26,160,-16,-10
2695,1,1,-42,-6,7
2696,1,-22,57,-3,-19
2697,1,-23,76,-4,-19
2698,1,-19,70,-14,-5
2699,1,-32,247,-13,-19
2700,1,-17,-18,-18,1
2701,1,18,32,2,16
2702,1,-20,91,-13,-7
2703,1,-1,-12,-4,3
2704,1,19,18,1,18
2705,1,-4,-252,14,-18
2706,1,10,-24,12,-2
2707,1,10,-75,15,-5
2708,1,-4,-45,5,-9
2709,1,19,18,18,1
2710,1,-7,-30,-10,3
2711,1,30,221,13,17
2712,1,36,323,19,17
2713,1,-8,0,0,-8
2714,1,1,-306,18,-17
2715,1,2,-24,6,-4
2716,1,0,-225,15,-15
2717,1,3,-270,18,-15
2718,1,-4,-192,12,-16
2719,1,28,160,8,20
2720,1,3,-238,17,-14
2721,1,-12,27,-9,-3
2722,1,-28,160,-20,-8
2723,1,12,-45,15,-3
2724,1,4,-60,10,-6
2725,1,-6,-112,8,-14
2726,1,-10,-200,-20,10
2727,1,-3,-88,8,-11
2728,1,-13,-68,-17,4
2729,1,15,0,0,15
2730,1,14,13,13,1
2731,1,-17,0,-17,0
2732,1,-11,24,-8,-3
2733,1,-11,-12,1,-12
2734,1,1,-272,-16,17
2735,1,22,96,16,6
2736,1,2,1,1,1
2737,1,-2,-288,-18,16
2738,1,-15,14,-14,-1
2739,1,-20,84,-14,-6
2740,1,15,-76,-4,19
2741,1,-4,-117,9,-13
2742,1,31,220,11,20
2743,1,15,-34,-2,17
2744,1,-3,-10,2,-5
2745,1,20,19,1,19
2746,1,-14,-120,6,-20
2747,1,11,24,8,3
2748,1,15,14,14,1
2749,1,6,5,5,1
2750,1,-17,60,-12,-5
2751,1,32,240,12,20
2752,1,4,-252,-14,18
2753,1,0,-1,-1,1
2754,1,-4,-45,-9,5
2755,1,1,-56,-7,8
2756,1,-29,210,-14,-15
2757,1,4,-96,12,-8
2758,1,9,-10,10,-1
2759,1,-17,60,-5,-12
2760,1,-13,36,-4,-9
2761,1,1,-342,19,-18
2762,1,-1,-272,-17,16
2763,1,2,-63,-7,9
2764,1,-1,-56,7,-8
2765,1,16,64,8,8
2766,1,0,-25,5,-5
2767,1,-3,-208,-16,13
2768,1,5,-104,13,-8
2769,1,24,108,6,18
2770,1,-27,170,-10,-17
2771,1,-16,64,-8,-8
2772,1,-10,-39,-13,3
2773,1,-14,13,-13,-1
2774,1,-1,0,0,-1
2775,1,-15,56,-8,-7
2776,1,-1,-240,15,-16
2777,1,13,-14,14,-1
2778,1,-8,-33,3,-11
2779,1,-33,266,-14,-19
2780,1,23,90,5,18
2781,1,-9,-112,-16,7
2782,1,3,-340,-17,20
2783,1,18,0,18,0
2784,1,-23,102,-6,-17
2785,1,22,40,2,20
2786,1,38,361,19,19
2787,1,5,-84,-7,12
2788,1,-12,20,-2,-10
2789,1,8,7,7,1
2790,1,8,7,7,1
2791,1,-19,70,-5,-14
2792,1,-19,48,-16,-3
2793,1,7,12,4,3
2794,1,-25,136,-8,-17
2795,1,8,-153,17,-9
2796,1,-11,18,-2,-9
2797,1,28,160,8,20
2798,1,-25,144,-16,-9
2799,1,14,24,12,2
2800,1,10,9,1,9
2801,1,-30,224,-16,-14
2802,1,1,-2,2,-1
2803,1,3,-4,-1,4
2804,1,-8,-48,4,-12
2805,1,12,-64,16,-4
2806,1,-5,-24,3,-8
2807,1,5,0,5,0
2808,1,-12,-64,4,-16
2809,1,-22,105,-7,-15
2810,1,-10,-144,-18,8
2811,1,-13,30,-10,-3
2812,1,-9,-90,6,-15
2813,1,5,-36,9,-4
2814,1,-2,-323,17,-19
2815,1,5,-84,12,-7
2816,1,11,-42,14,-3
2817,1,-32,247,-19,-13
2818,1,-13,-30,-15,2
2819,1,-7,0,-7,0
2820,1,15,-34,-2,17
2821,1,-1,-72,-9,8
2822,1,-23,76,-4,-19
2823,1,-7,-18,-9,2
2824,1,-8,-48,-12,4
2825,1,1,-2,2,-1
2826,1,-6,-40,4,-10
2827,1,10,24,4,6
2828,1,-11,-60,-15,4
2829,1,-17,66,-6,-11
2830,1,11,-60,15,-4
2831,1,18,0,0,18
2832,1,-27,162,-18,-9
2833,1,5,-300,-15,20
2834,1,-25,156,-13,-12
2835,1,14,-15,15,-1
2836,1,0,-196,-14,14
2837,1,0,-16,4,-4
2838,1,-7,0,0,-7
2839,1,-14,-15,1,-15
2840,1,-17,60,-12,-5
2841,1,1,-42,-6,7
2842,1,17,-18,-1,18
2843,1,26,169,13,13
2844,1,-13,-30,-15,2
2845,1,-16,60,-6,-10
2846,1,-19,-20,-20,1
2847,1,-15,-54,3,-18
2848,1,-4,-60,6,-10
2849,1,7,-30,10,-3
2850,1,-7,-8,1,-8
2851,1,25,100,20,5
2852,1,-14,0,-14,0
2853,1,-19,48,-3,-16
2854,1,-6,-112,8,-14
2855,1,3,-10,5,-2
2856,1,-2,-3,-3,1
2857,1,1,-306,-17,18
2858,1,-26,160,-10,-16
2859,1,28,192,12,16
2860,1,8,-9,-1,9
2861,1,33,266,14,19
2862,1,13,12,1,12
2863,1,-5,4,-1,-4
2864,1,19,90,10,9
2865,1,-3,-4,1,-4
2866,1,-20,96,-8,-12
2867,1,-3,0,-3,0
2868,1,2,0,2,0
2869,1,-12,36,-6,-6
2870,1,-32,256,-16,-16
2871,1,-16,60,-10,-6
2872,1,-7,10,-2,-5
2873,1,-21,98,-14,-7
2874,1,1,-72,9,-8
2875,1,-6,-112,8,-14
2876,1,20,19,1,19
2877,1,1,-380,-19,20
2878,1,9,-162,-9,18
2879,1,23,120,15,8
2880,1,7,-228,19,-12
2881,1,-26,153,-17,-9
2882,1,-28,196,-14,-14
2883,1,-3,-154,11,-14
2884,1,27,182,14,13
2885,1,-15,14,-1,-14
2886,1,-7,-30,3,-10
2887,1,-9,-220,11,-20
2888,1,-18,65,-5,-13
2889,1,33,270,18,15
2890,1,-29,204,-17,-12
2891,1,-4,-192,12,-16
2892,1,28,192,16,12
2893,1,-30,200,-10,-20
2894,1,-1,-6,-3,2
2895,1,-14,-72,4,-18
2896,1,17,16,1,16
2897,1,-21,38,-2,-19
2898,1,17,0,17,0
2899,1,21,90,6,15
2900,1,2,-120,-10,12
2901,1,-19,70,-14,-5
2902,1,-22,112,-8,-14
2903,1,25,114,6,19
2904,1,17,66,11,6
2905,1,-19,78,-13,-6
2906,1,-8,-128,8,-16
2907,1,-2,-360,18,-20
2908,1,24,119,7,17
2909,1,-25,136,-17,-8
2910,1,-29,180,-9,-20
2911,1,7,12,4,3
2912,1,12,20,2,10
2913,1,-7,-260,-20,13
2914,1,28,192,12,16
2915,1,25,100,5,20
2916,1,12,-28,14,-2
2917,1,4,-5,-1,5
2918,1,-11,0,-11,0
2919,1,10,24,4,6
2920,1,-17,-18,-18,1
2921,1,0,-16,-4,4
2922,1,13,36,4,9
2923,1,-24,143,-13,-11
2924,1,-2,-195,-15,13
2925,1,14,-51,-3,17
2926,1,9,-190,19,-10
2927,1,4,-32,8,-4
2928,1,-6,-112,8,-14
2929,1,6,-7,-1,7
2930,1,4,-140,14,-10
2931,1,25,136,17,8
2932,1,7,-260,20,-13
2933,1,1,-42,7,-6
2934,1,1,-240,-15,16
2935,1,7,10,5,2
2936,1,-7,10,-5,-2
2937,1,5,-50,-5,10
2938,1,9,20,5,4
2939,1,-8,15,-5,-3
2940,1,-9,20,-5,-4
2941,1,-8,-240,12,-20
2942,1,9,-136,17,-8
2943,1,-22,117,-13,-9
2944,1,10,-171,19,-9
2945,1,-34,289,-17,-17
2946,1,-29,210,-14,-15
2947,1,1,-72,-8,9
2948,1,6,-40,10,-4
2949,1,4,-320,-16,20
2950,1,-15,-76,-19,4
2951,1,31,234,18,13
2952,1,17,-60,20,-3
2953,1,-9,0,-9,0
2954,1,-28,171,-9,-19
2955,1,-26,153,-9,-17
2956,1,-20,84,-14,-6
2957,1,13,-68,17,-4
2958,1,2,-80,10,-8
2959,1,-6,5,-1,-5
2960,1,-12,20,-2,-10
2961,1,2,-8,4,-2
2962,1,-1,-2,-2,1
2963,1,-15,50,-10,-5
2964,1,36,323,19,17
2965,1,33,260,13,20
2966,1,19,34,2,17
2967,1,-3,-180,12,-15
2968,1,26,144,8,18
2969,1,10,24,6,4
2970,1,11,24,8,3
2971,1,-4,-12,2,-6
2972,1,6,5,5,1
2973,1,6,8,4,2
2974,1,7,-260,20,-13
2975,1,13,-114,19,-6
2976,1,3,-4,4,-1
2977,1,1,-272,17,-16
2978,1,14,40,10,4
2979,1,16,55,11,5
2980,1,9,-220,20,-11
2981,1,7,10,5,2
2982,1,-10,-11,1,-11
2983,1,-2,-143,-13,11
2984,1,-1,-210,14,-15
2985,1,-19,78,-6,-13
2986,1,-1,-42,6,-7
2987,1,21,54,3,18
2988,1,23,126,9,14
2989,1,-25,126,-7,-18
2990,1,0,-100,10,-10
2991,1,-24,80,-20,-4
2992,1,-24,143,-13,-11
2993,1,-20,64,-16,-4
2994,1,13,36,9,4
2995,1,12,-160,20,-8
2996,1,32,240,12,20
2997,1,-4,-96,-12,8
2998,1,6,-27,9,-3
2999,1,-14,-32,-16,2
3000,1,13,-114,19,-6
3001,1,-23,112,-16,-7
3002,1,12,-64,-4,16
3003,1,20,91,13,7
3004,1,7,-8,-1,8
3005,1,-4,-5,1,-5
3006,1,-21,80,-16,-5
3007,1,3,0,3,0
3008,1,5,-84,12,-7
3009,1,0,-9,3,-3
3010,1,11,24,8,3
3011,1,21,98,7,14
3012,1,-19,0,-19,0
3013,1,4,-221,-13,17
3014,1,-31,220,-20,-11
3015,1,10,-75,15,-5
3016,1,14,-51,-3,17
3017,1,26,165,11,15
3018,1,1,-2,2,-1
3019,1,25,144,9,16
3020,1,-39,380,-19,-20
3021,1,-17,70,-7,-10
3022,1,-14,-51,3,-17
3023,1,11,-42,-3,14
3024,1,-11,18,-2,-9
3025,1,0,-400,20,-20
3026,1,-23,76,-4,-19
3027,1,-1,-42,6,-7
3028,1,-7,12,-4,-3
3029,1,-5,-36,-9,4
3030,1,-13,-30,2,-15
3031,1,-7,-260,-20,13
3032,1,-1,-210,-15,14
3033,1,-17,0,-17,0
3034,1,-1,-72,-9,8
3035,1,6,-247,19,-13
3036,1,-13,-68,4,-17
3037,1,-4,-192,12,-16
3038,1,-26,168,-12,-14
3039,1,-35,306,-17,-18
3040,1,7,-60,-5,12
3041,1,-15,50,-5,-10
3042,1,7,0,7,0
3043,1,26,120,6,20
3044,1,-25,114,-6,-19
3045,1,22,112,8,14
3046,1,-16,48,-4,-12
3047,1,-27,152,-8,-19
3048,1,0,-25,-5,5
3049,1,-12,-45,-15,3
3050,1,-6,8,-2,-4
3051,1,21,110,10,11
3052,1,30,200,10,20
3053,1,-13,12,-12,-1
3054,1,-20,19,-19,-1
3055,1,12,35,7,5
3056,1,-4,-285,-19,15
3057,1,-9,8,-8,-1
3058,1,-17,72,-8,-9
3059,1,4,3,3,1
3060,1,-2,-24,4,-6
3061,1,24,108,6,18
3062,1,-1,-240,15,-16
3063,1,-27,152,-19,-8
3064,1,-12,0,0,-12
3065,1,-13,30,-3,-10
3066,1,-5,-234,-18,13
3067,1,-30,221,-17,-13
3068,1,-3,-10,-5,2
3069,1,11,10,10,1
3070,1,11,-102,17,-6
3071,1,15,36,3,12
3072,1,-8,-20,-10,2
3073,1,8,-33,-3,11
3074,1,-26,120,-6,-20
3075,1,15,-54,18,-3
3076,1,-10,-39,-13,3
3077,1,-15,56,-8,-7
3078,1,12,-13,-1,13
3079,1,-11,-26,-13,2
3080,1,3,0,3,0
3081,1,0,-400,-20,20
3082,1,13,36,9,4
3083,1,3,-40,-5,8
3084,1,10,9,9,1
3085,1,11,-126,18,-7
3086,1,13,-14,-1,14
3087,1,0,-169,13,-13
3088,1,-6,9,-3,-3
3089,1,28,160,8,20
3090,1,-1,-6,2,-3
3091,1,-14,-95,-19,5
3092,1,3,-180,15,-12
3093,1,-29,204,-12,-17
3094,1,27,182,14,13
3095,1,4,-221,17,-13
3096,1,-17,72,-8,-9
3097,1,1,-12,-3,4
3098,1,-6,-160,10,-16
3099,1,2,-8,4,-2
3100,1,-6,-160,10,-16
3101,1,0,-361,19,-19
3102,1,34,285,15,19
3103,1,21,38,2,19
3104,1,-7,-18,-9,2
3105,1,4,-12,6,-2
3106,1,-9,20,-4,-5
3107,1,-28,195,-15,-13
3108,1,4,-140,-10,14
3109,1,7,-44,-4,11
3110,1,19,78,13,6
3111,1,-17,0,0,-17
3112,1,-32,240,-12,-20
3113,1,10,-171,19,-9
3114,1,-6,-16,2,-8
3115,1,2,-63,-7,9
3116,1,3,-4,-1,4
3117,1,-8,-33,-11,3
3118,1,-21,108,-12,-9
3119,1,24,140,14,10
3120,1,-8,-65,-13,5
3121,1,17,-18,18,-1
3122,1,4,-60,-6,10
3123,1,24,119,7,17
3124,1,4,3,1,3
3125,1,24,108,18,6
3126,1,5,6,3,2
3127,1,-28,195,-13,-15
3128,1,10,-144,-8,18
3129,1,-4,-320,16,-20
3130,1,-21,68,-4,-17
3131,1,25,154,14,11
3132,1,-11,-126,7,-18
3133,1,-20,0,-20,0
3134,1,-36,323,-17,-19
3135,1,-5,-50,5,-10
3136,1,1,-272,-16,17
3137,1,8,-9,-1,9
3138,1,10,-144,-8,18
3139,1,25,114,6,19
3140,1,9,-162,-9,18
3141,1,-21,20,-20,-1
3142,1,-24,119,-17,-7
3143,1,-2,-80,-10,8
3144,1,-5,-6,1,-6
3145,1,18,-40,20,-2
3146,1,-9,-70,5,-14
3147,1,-3,-180,12,-15
3148,1,4,4,2,2
3149,1,-7,6,-1,-6
3150,1,11,-12,12,-1
3151,1,31,220,20,11
3152,1,34,280,14,20
3153,1,-9,-22,-11,2
3154,1,22,85,17,5
3155,1,13,-48,-3,16
3156,1,30,221,13,17
3157,1,28,180,10,18
3158,1,-4,-12,-6,2
3159,1,7,-120,15,-8
3160,1,-23,102,-17,-6
3161,1,27,152,8,19
3162,1,-8,7,-1,-7
3163,1,-13,-114,-19,6
3164,1,-16,63,-7,-9
3165,1,7,-198,18,-11
3166,1,-28,171,-19,-9
3167,1,-6,-280,-20,14
3168,1,9,-112,16,-7
3169,1,20,19,1,19
3170,1,1,-272,17,-16
3171,1,0,-4,2,-2
3172,1,-37,340,-17,-20
3173,1,2,-288,-16,18
3174,1,12,-28,14,-2
3175,1,0,-100,10,-10
3176,1,-2,-24,-6,4
3177,1,9,-162,18,-9
3178,1,17,16,1,16
3179,1,17,30,15,2
3180,1,-7,-60,5,-12
3181,1,-17,-60,-20,3
3182,1,-2,-63,-9,7
3183,1,2,0,0,2
3184,1,-31,220,-11,-20
3185,1,9,20,5,4
3186,1,-25,114,-6,-19
3187,1,-26,133,-7,-19
3188,1,-14,-51,3,-17
3189,1,2,-35,-5,7
3190,1,19,88,8,11
3191,1,-9,-36,3,-12
3192,1,30,209,11,19
3193,1,7,-78,-6,13
3194,1,7,-44,11,-4
3195,1,34,288,18,16
3196,1,32,255,15,17
3197,1,8,-84,14,-6
3198,1,9,-70,-5,14
3199,1,5,-50,-5,10
3200,1,7,6,1,6
3201,1,3,-88,-8,11
3202,1,-31,240,-15,-16
3203,1,1,-182,-13,14
3204,1,17,66,11,6
3205,1,-25,154,-11,-14
3206,1,31,234,18,13
3207,1,32,255,17,15
3208,1,20,84,14,6
3209,1,-1,-380,-20,19
3210,1,-1,-30,5,-6
3211,1,13,12,1,12
3212,1,-8,-65,-13,5
3213,1,8,-105,-7,15
3214,1,6,-280,20,-14
3215,1,-18,-19,1,-19
3216,1,-3,-18,-6,3
3217,1,-10,0,-10,0
3218,1,22,72,18,4
3219,1,1,-380,-19,20
3220,1,-10,-75,-15,5
3221,1,-7,-78,-13,6
3222,1,0,-225,-15,15
3223,1,-2,-99,-11,9
3224,1,35,306,17,18
3225,1,-27,152,-8,-19
3226,1,8,15,5,3
3227,1,-7,-198,11,-18
3228,1,19,78,6,13
3229,1,10,16,8,2
3230,1,-8,-128,8,-16
3231,1,-35,300,-15,-20
3232,1,27,140,7,20
3233,1,20,99,11,9
3234,1,13,22,11,2
3235,1,15,-16,-1,16
3236,1,-29,210,-15,-14
3237,1,30,221,17,13
3238,1,-5,-234,-18,13
3239,1,-4,-12,-6,2
3240,1,-4,-165,11,-15
3241,1,17,0,17,0
3242,1,-25,100,-20,-5
3243,1,11,-102,17,-6
3244,1,-6,-40,4,-10
3245,1,12,27,9,3
3246,1,-33,266,-19,-14
3247,1,11,10,10,1
3248,1,0,-36,-6,6
3249,1,17,72,9,8
3250,1,7,-260,20,-13
3251,1,-14,48,-8,-6
3252,1,-1,0,-1,0
3253,1,31,234,13,18
3254,1,20,64,16,4
3255,1,1,0,0,1
3256,1,8,-180,18,-10
3257,1,6,-27,-3,9
3258,1,-7,-120,-15,8
3259,1,6,-16,8,-2
3260,1,-13,42,-6,-7
3261,1,13,-48,16,-3
3262,1,31,238,17,14
3263,1,-29,190,-19,-10
3264,1,-1,-72,8,-9
3265,1,-10,-119,-17,7
3266,1,9,-112,16,-7
3267,1,23,120,8,15
3268,1,6,0,0,6
3269,1,-6,-16,-8,2
3270,1,-12,20,-2,-10
3271,1,1,-156,-12,13
3272,1,0,-169,-13,13
3273,1,-4,-21,3,-7
3274,1,7,-120,-8,15
3275,1,27,182,14,13
3276,1,7,10,2,5
3277,1,17,-38,19,-2
3278,1,17,0,0,17
3279,1,14,-95,-5,19
3280,1,30,224,16,14
3281,1,-19,-20,1,-20
3282,1,-1,-2,-2,1
3283,1,10,-119,-7,17
3284,1,5,-50,-5,10
3285,1,0,-196,14,-14
3286,1,-3,0,-3,0
3287,1,35,306,18,17
3288,1,-10,-119,-17,7
3289,1,-9,-112,7,-16
3290,1,20,91,7,13
3291,1,-19,48,-3,-16
3292,1,-7,10,-5,-2
3293,1,21,104,13,8
3294,1,10,-75,-5,15
3295,1,25,136,8,17
3296,1,-7,-44,-11,4
3297,1,9,-52,13,-4
3298,1,1,-182,-13,14
3299,1,0,-225,15,-15
3300,1,18,65,13,5
3301,1,39,380,20,19
3302,1,3,-4,-1,4
3303,1,-8,-240,-20,12
3304,1,-24,80,-4,-20
3305,1,-11,-102,6,-17
3306,1,25,136,17,8
3307,1,1,-90,10,-9
3308,1,-18,77,-7,-11
3309,1,-25,100,-5,-20
3310,1,-3,-4,1,-4
3311,1,4,-77,11,-7
3312,1,5,-104,13,-8
3313,1,0,-196,-14,14
3314,1,35,304,16,19
3315,1,16,63,9,7
3316,1,-4,0,-4,0
3317,1,3,-340,-17,20
3318,1,-4,-252,-18,14
3319,1,-7,-60,-12,5
3320,1,2,-48,-6,8
3321,1,-30,200,-10,-20
3322,1,-24,135,-9,-15
3323,1,38,361,19,19
3324,1,28,160,8,20
3325,1,17,30,2,15
3326,1,-32,247,-13,-19
3327,1,-26,120,-20,-6
3328,1,-12,35,-5,-7
3329,1,0,-4,-2,2
3330,1,28,171,9,19
3331,1,3,-88,-8,11
3332,1,17,30,2,15
3333,1,-13,36,-4,-9
3334,1,-18,65,-13,-5
3335,1,6,0,0,6
3336,1,-9,-190,-19,10
3337,1,-27,170,-10,-17
3338,1,27,162,9,18
3339,1,9,-220,20,-11
3340,1,-3,-154,-14,11
3341,1,8,-33,11,-3
3342,1,24,108,6,18
3343,1,-11,30,-5,-6
3344,1,-29,198,-11,-18
3345,1,18,32,16,2
3346,1,-20,100,-10,-10
3347,1,-19,48,-3,-16
3348,1,15,-76,-4,19
3349,1,-3,-154,11,-14
3350,1,-32,240,-12,-20
3351,1,6,-27,-3,9
3352,1,17,-18,18,-1
3353,1,-12,20,-2,-10
3354,1,-24,108,-6,-18
3355,1,15,26,2,13
3356,1,29,180,20,9
3357,1,6,5,1,5
3358,1,32,255,15,17
3359,1,-8,-20,2,-10
3360,1,-15,-16,-16,1
3361,1,20,96,8,12
3362,1,-9,-70,-14,5
3363,1,16,28,2,14
3364,1,23,102,17,6
3365,1,-27,170,-17,-10
3366,1,-14,48,-8,-6
3367,1,17,72,9,8
3368,1,12,-64,-4,16
3369,1,15,36,12,3
3370,1,-34,280,-14,-20
3371,1,25,156,13,12
3372,1,2,-48,-6,8
3373,1,-36,320,-16,-20
3374,1,3,-4,-1,4
3375,1,-16,-36,2,-18
3376,1,-17,0,0,-17
3377,1,8,-20,10,-2
3378,1,-16,63,-9,-7
3379,1,13,-140,20,-7
3380,1,-7,-18,2,-9
3381,1,22,96,16,6
3382,1,-11,24,-8,-3
3383,1,-19,34,-17,-2
3384,1,-23,132,-12,-11
3385,1,-9,-36,3,-12
3386,1,-12,-133,7,-19
3387,1,-13,36,-4,-9
3388,1,19,90,10,9
3389,1,-3,-304,16,-19
3390,1,-9,-22,-11,2
3391,1,-19,-20,-20,1
3392,1,-28,160,-8,-20
3393,1,3,-108,12,-9
3394,1,-2,-24,4,-6
3395,1,9,14,7,2
3396,1,28,195,13,15
3397,1,-25,114,-6,-19
3398,1,-16,28,-2,-14
3399,1,-12,20,-2,-10
3400,1,-5,6,-3,-2
3401,1,5,-24,-3,8
3402,1,6,9,3,3
3403,1,-14,33,-11,-3
3404,1,7,-98,14,-7
3405,1,-24,143,-13,-11
3406,1,4,3,1,3
3407,1,-16,55,-5,-11
3408,1,18,32,16,2
3409,1,35,304,19,16
3410,1,32,247,19,13
3411,1,-2,-323,-19,17
3412,1,-31,234,-13,-18
3413,1,-13,-90,5,-18
3414,1,-1,-72,-9,8
3415,1,-24,128,-16,-8
3416,1,-5,-66,6,-11
3417,1,7,-144,-9,16
3418,1,-15,14,-1,-14
3419,1,-9,18,-6,-3
3420,1,1,-110,-10,11
3421,1,34,280,20,14
3422,1,10,24,6,4
3423,1,24,140,10,14
3424,1,29,208,16,13
3425,1,-4,3,-3,-1
3426,1,26,165,11,15
3427,1,28,196,14,14
3428,1,-25,126,-18,-7
3429,1,-4,-221,13,-17
3430,1,1,-30,6,-5
3431,1,-18,-40,-20,2
3432,1,13,42,7,6
3433,1,-16,63,-9,-7
3434,1,-24,128,-16,-8
3435,1,11,10,1,10
3436,1,14,-72,-4,18
3437,1,-16,-57,-19,3
3438,1,19,0,0,19
3439,1,-10,0,-10,0
3440,1,-24,143,-11,-13
3441,1,-2,-8,2,-4
3442,1,29,204,12,17
3443,1,-11,-126,-18,7
3444,1,0,-361,-19,19
3445,1,30,224,14,16
3446,1,0,-256,-16,16
3447,1,-22,117,-9,-13
3448,1,-34,288,-16,-18
3449,1,32,255,17,15
3450,1,4,-221,-13,17
3451,1,-13,-140,7,-20
3452,1,-20,75,-5,-15
3453,1,0,-324,18,-18
3454,1,-24,119,-17,-7
3455,1,2,-3,-1,3
3456,1,2,-35,7,-5
3457,1,6,-160,-10,16
3458,1,-15,54,-6,-9
3459,1,8,0,8,0
3460,1,-22,120,-10,-12
3461,1,15,-16,16,-1
3462,1,-17,70,-7,-10
3463,1,-12,-13,1,-13
3464,1,-7,-78,6,-13
3465,1,27,182,14,13
3466,1,-9,-136,8,-17
3467,1,5,-6,6,-1
3468,1,19,60,4,15
3469,1,-29,210,-14,-15
3470,1,-26,153,-17,-9
3471,1,18,56,4,14
3472,1,5,-84,-7,12
3473,1,18,0,0,18
3474,1,-28,195,-13,-15
3475,1,22,72,4,18
3476,1,12,-85,17,-5
3477,1,13,-140,-7,20
3478,1,-26,133,-19,-7
3479,1,5,-266,19,-14
3480,1,29,180,20,9
3481,1,-11,-26,2,-13
3482,1,8,-128,-8,16
3483,1,2,-195,15,-13
3484,1,-32,255,-17,-15
3485,1,-10,-119,-17,7
3486,1,-5,-104,-13,8
3487,1,17,42,14,3
3488,1,2,-224,16,-14
3489,1,0,-25,5,-5
3490,1,9,-190,19,-10
3491,1,6,5,1,5
3492,1,-12,-13,1,-13
3493,1,-3,-4,-4,1
3494,1,-12,-160,-20,8
3495,1,-5,-126,9,-14
3496,1,-2,-143,11,-13
3497,1,-7,-60,-12,5
3498,1,-28,187,-11,-17
3499,1,-15,-54,3,-18
3500,1,-1,-306,17,-18
3501,1,-25,150,-15,-10
3502,1,-2,-3,1,-3
3503,1,-25,114,-19,-6
3504,1,-15,44,-4,-11
3505,1,-23,112,-16,-7
3506,1,0,-225,-15,15
3507,1,5,-126,-9,14
3508,1,-25,114,-6,-19
3509,1,2,-99,11,-9
3510,1,-30,221,-17,-13
3511,1,-27,182,-14,-13
3512,1,-7,-60,-12,5
3513,1,2,-360,-18,20
3514,1,-17,70,-7,-10
3515,1,13,12,12,1
3516,1,21,20,1,20
3517,1,-18,45,-15,-3
3518,1,-11,30,-5,-6
3519,1,-18,77,-7,-11
3520,1,-6,-160,10,-16
3521,1,3,-70,-7,10
3522,1,-33,272,-16,-17
3523,1,-3,-18,3,-6
3524,1,-2,-143,-13,11
3525,1,27,140,20,7
3526,1,-10,-200,10,-20
3527,1,30,224,14,16
3528,1,14,-95,19,-5
3529,1,28,196,14,14
3530,1,13,-140,20,-7
3531,1,-2,-99,9,-11
3532,1,7,0,7,0
3533,1,12,32,8,4
3534,1,4,-96,-8,12
3535,1,0,0,0,0
3536,1,30,225,15,15
3537,1,31,228,12,19
3538,1,-13,40,-5,-8
3539,1,2,-63,9,-7
3540,1,-10,-171,9,-19
3541,1,20,64,16,4
3542,1,-11,-152,8,-19
3543,1,30,216,18,12
3544,1,28,180,10,18
3545,1,24,143,11,13
3546,1,10,-144,-8,18
3547,1,0,-256,16,-16
3548,1,-17,42,-3,-14
3549,1,-4,-60,6,-10
3550,1,-16,63,-7,-9
3551,1,0,-64,8,-8
3552,1,-21,108,-12,-9
3553,1,13,40,5,8
3554,1,-8,-128,8,-16
3555,1,14,-15,-1,15
3556,1,0,-25,-5,5
3557,1,-11,-180,9,-20
3558,1,-12,27,-3,-9
3559,1,-13,-90,5,-18
3560,1,9,0,9,0
3561,1,20,36,2,18
3562,1,8,-128,-8,16
3563,1,-1,-72,-9,8
3564,1,-3,-130,10,-13
3565,1,-9,-10,1,-10
3566,1,4,-12,6,-2
3567,1,31,238,17,14
3568,1,8,-48,12,-4
3569,1,-13,-48,3,-16
3570,1,15,50,5,10
3571,1,-6,-135,9,-15
3572,1,-9,-90,-15,6
3573,1,33,266,19,14
3574,1,3,-238,-14,17
3575,1,-7,-198,11,-18
3576,1,-17,70,-7,-10
3577,1,-23,120,-8,-15
3578,1,-30,209,-11,-19
3579,1,-18,17,-1,-17
3580,1,20,0,20,0
3581,1,12,-108,-6,18
3582,1,-17,0,0,-17
3583,1,-25,144,-16,-9
3584,1,-19,48,-16,-3
3585,1,-15,14,-14,-1
3586,1,14,0,14,0
3587,1,-6,-7,-7,1
3588,1,8,-180,18,-10
3589,1,16,60,6,10
3590,1,-5,-84,7,-12
3591,1,-20,0,-20,0
3592,1,-17,16,-1,-16
3593,1,-36,320,-16,-20
3594,1,16,15,1,15
3595,1,3,-130,13,-10
3596,1,16,55,11,5
3597,1,7,-44,-4,11
3598,1,0,-169,13,-13
3599,1,32,255,17,15
3600,1,3,-130,13,-10
3601,1,-11,-26,2,-13
3602,1,-11,0,0,-11
3603,1,-9,-52,4,-13
3604,1,9,-36,12,-3
3605,1,-3,-10,-5,2
3606,1,34,289,17,17
3607,1,17,66,11,6
3608,1,-9,-22,2,-11
3609,1,-1,-42,-7,6
3610,1,-5,0,-5,0
3611,1,-12,-160,8,-20
3612,1,-5,-24,-8,3
3613,1,-13,0,0,-13
3614,1,23,132,11,12
3615,1,11,-180,20,-9
3616,1,1,-42,7,-6
3617,1,-8,16,-4,-4
3618,1,14,-120,-6,20
3619,1,15,-16,16,-1
3620,1,11,10,1,10
3621,1,-5,-36,4,-9
3622,1,-10,-11,-11,1
3623,1,22,112,8,14
3624,1,3,0,0,3
3625,1,-17,72,-8,-9
3626,1,15,50,10,5
3627,1,-7,-260,13,-20
3628,1,-2,-323,-19,17
3629,1,-5,-24,3,-8
3630,1,7,-198,18,-11
3631,1,10,-11,-1,11
3632,1,13,40,8,5
3633,1,25,144,16,9
3634,1,2,-143,-11,13
3635,1,32,240,12,20
3636,1,-2,-255,15,-17
3637,1,6,-247,-13,19
3638,1,-10,-200,10,-20
3639,1,-28,192,-16,-12
3640,1,27,162,18,9
3641,1,10,-144,-8,18
3642,1,-5,-204,-17,12
3643,1,-23,132,-11,-12
3644,1,7,-198,-11,18
3645,1,4,-45,-5,9
3646,1,-13,36,-9,-4
3647,1,-21,98,-7,-14
3648,1,-40,400,-20,-20
3649,1,-11,-12,1,-12
3650,1,24,108,6,18
3651,1,-9,14,-7,-2
3652,1,1,-182,14,-13
3653,1,-14,40,-10,-4
3654,1,10,-171,-9,19
3655,1,-35,306,-18,-17
3656,1,5,-104,13,-8
3657,1,-16,63,-9,-7
3658,1,19,90,10,9
3659,1,-4,-12,-6,2
3660,1,5,6,2,3
3661,1,-21,80,-5,-16
3662,1,-38,361,-19,-19
3663,1,10,24,4,6
3664,1,-26,153,-17,-9
3665,1,7,-8,-1,8
3666,1,0,-196,14,-14
3667,1,-16,60,-6,-10
3668,1,-13,-68,-17,4
3669,1,29,198,11,18
3670,1,19,34,2,17
3671,1,4,-32,8,-4
3672,1,26,153,9,17
3673,1,-22,120,-10,-12
3674,1,-7,-98,-14,7
3675,1,-4,-60,-10,6
3676,1,33,266,19,14
3677,1,24,128,8,16
3678,1,-7,10,-5,-2
3679,1,13,-30,15,-2
3680,1,-19,78,-13,-6
3681,1,-14,-51,-17,3
3682,1,-19,34,-17,-2
3683,1,18,72,6,12
3684,1,-2,-35,5,-7
3685,1,-15,-76,-19,4
3686,1,-32,255,-17,-15
3687,1,14,-72,-4,18
3688,1,-19,88,-11,-8
3689,1,10,-171,19,-9
3690,1,5,-204,17,-12
3691,1,6,8,2,4
3692,1,-1,-182,-14,13
3693,1,-37,340,-17,-20
3694,1,16,-36,18,-2
3695,1,14,-32,-2,16
3696,1,-11,-102,6,-17
3697,1,-10,-11,1,-11
3698,1,2,-99,11,-9
3699,1,13,22,2,11
3700,1,-12,-160,8,-20
3701,1,7,-170,17,-10
3702,1,-19,-20,-20,1
3703,1,6,-247,-13,19
3704,1,-3,-10,-5,2
3705,1,-13,12,-12,-1
3706,1,-14,-15,-15,1
3707,1,-15,0,0,-15
3708,1,4,-96,-8,12
3709,1,12,27,3,9
3710,1,17,72,8,9
3711,1,-7,0,0,-7
3712,1,13,22,11,2
3713,1,0,-9,3,-3
3714,1,14,-32,-2,16
3715,1,-1,-42,-7,6
3716,1,-8,15,-5,-3
3717,1,0,-289,-17,17
3718,1,23,112,7,16
3719,1,-25,114,-19,-6
3720,1,4,-45,-5,9
3721,1,-10,-171,-19,9
3722,1,23,126,9,14
3723,1,-8,-153,-17,9
3724,1,11,10,10,1
3725,1,-22,57,-19,-3
3726,1,-24,119,-7,-17
3727,1,-12,-108,6,-18
3728,1,-22,120,-12,-10
3729,1,-9,14,-2,-7
3730,1,-13,-90,5,-18
3731,1,-18,-19,-19,1
3732,1,5,-126,14,-9
3733,1,6,0,6,0
3734,1,1,-110,11,-10
3735,1,3,-238,-14,17
3736,1,26,144,8,18
3737,1,-20,0,-20,0
3738,1,-11,0,-11,0
3739,1,11,10,1,10
3740,1,14,-120,20,-6
3741,1,-1,-2,1,-2
3742,1,4,-32,-4,8
3743,1,15,-16,-1,16
3744,1,9,14,2,7
3745,1,17,-38,19,-2
3746,1,-7,-120,-15,8
3747,1,19,18,18,1
3748,1,-16,-57,3,-19
3749,1,-3,-4,-4,1
3750,1,-11,-126,-18,7
3751,1,-7,10,-2,-5
3752,1,0,-144,12,-12
3753,1,-5,-300,-20,15
3754,1,-5,4,-4,-1
3755,1,-35,300,-15,-20
3756,1,21,80,5,16
3757,1,-31,240,-16,-15
3758,1,35,304,19,16
3759,1,9,-112,16,-7
3760,1,7,-170,17,-10
3761,1,-15,36,-3,-12
3762,1,-39,380,-19,-20
3763,1,0,-289,-17,17
3764,1,31,240,15,16
3765,1,3,-10,-2,5
3766,1,-9,18,-3,-6
3767,1,33,270,18,15
3768,1,1,-182,-13,14
3769,1,10,0,0,10
3770,1,-3,-88,8,-11
3771,1,16,39,3,13
3772,1,-4,-285,15,-19
3773,1,-30,216,-18,-12
3774,1,22,57,19,3
3775,1,17,42,14,3
3776,1,-2,-255,-17,15
3777,1,-5,-36,-9,4
3778,1,-7,-30,-10,3
3779,1,-1,-380,19,-20
3780,1,17,30,15,2
3781,1,-1,-380,19,-20
3782,1,-36,323,-19,-17
3783,1,14,45,5,9
3784,1,19,78,13,6
3785,1,28,187,11,17
3786,1,25,136,8,17
3787,1,-4,-5,1,-5
3788,1,31,234,13,18
3789,1,-22,57,-19,-3
3790,1,0,-81,9,-9
3791,1,-1,-6,-3,2
3792,1,-13,-68,4,-17
3793,1,12,20,10,2
3794,1,6,8,4,2
3795,1,6,-187,17,-11
3796,1,20,96,12,8
3797,1,3,-10,-2,5
3798,1,37,340,17,20
3799,1,-25,100,-5,-20
3800,1,22,85,17,5
3801,1,6,-112,14,-8
3802,1,0,-100,10,-10
3803,1,-9,-90,6,-15
3804,1,9,-190,19,-10
3805,1,-26,133,-19,-7
3806,1,23,76,4,19
3807,1,1,-90,10,-9
3808,1,-29,198,-18,-11
3809,1,-12,35,-5,-7
3810,1,16,15,15,1
3811,1,24,95,19,5
3812,1,8,-65,-5,13
3813,1,-13,42,-6,-7
3814,1,5,-234,-13,18
3815,1,-7,-198,11,-18
3816,1,-26,165,-15,-11
3817,1,-14,-15,1,-15
3818,1,10,-24,-2,12
3819,1,-5,-50,-10,5
3820,1,-11,-152,8,-19
3821,1,29,190,10,19
3822,1,-2,-323,-19,17
3823,1,5,4,1,4
3824,1,23,60,3,20
3825,1,23,90,5,18
3826,1,-3,-208,-16,13
3827,1,27,170,17,10
3828,1,30,209,11,19
3829,1,32,252,14,18
3830,1,-25,114,-19,-6
3831,1,13,42,7,6
3832,1,-10,-11,-11,1
3833,1,12,-108,-6,18
3834,1,8,-209,-11,19
3835,1,27,140,20,7
3836,1,-13,40,-5,-8
3837,1,1,-306,-17,18
3838,1,-1,-272,-17,16
3839,1,28,160,20,8
3840,1,-27,140,-20,-7
3841,1,4,-32,-4,8
3842,1,-12,-160,-20,8
3843,1,6,-40,10,-4
3844,1,36,324,18,18
3845,1,26,169,13,13
3846,1,1,-56,8,-7
3847,1,-20,19,-1,-19
3848,1,-4,-285,15,-19
3849,1,3,-18,-3,6
3850,1,1,-156,13,-12
3851,1,0,-49,7,-7
3852,1,-26,165,-11,-15
3853,1,18,80,8,10
3854,1,22,57,19,3
3855,1,-9,-162,9,-18
3856,1,4,-221,-13,17
3857,1,-28,195,-15,-13
3858,1,7,-60,12,-5
3859,1,-20,99,-9,-11
3860,1,14,-32,16,-2
3861,1,1,-342,-18,19
3862,1,-1,-12,-4,3
3863,1,-11,18,-2,-9
3864,1,-25,100,-5,-20
3865,1,-29,198,-11,-18
3866,1,-23,126,-9,-14
3867,1,0,-9,-3,3
3868,1,9,-10,-1,10
3869,1,-23,90,-5,-18
3870,1,-5,-50,5,-10
3871,1,-5,4,-1,-4
3872,1,18,81,9,9
3873,1,15,-100,20,-5
3874,1,21,110,10,11
3875,1,17,60,12,5
3876,1,-18,65,-5,-13
3877,1,-22,85,-5,-17
3878,1,-15,14,-1,-14
3879,1,-7,-8,1,-8
3880,1,-3,-208,13,-16
3881,1,-2,-360,-20,18
3882,1,-2,-120,10,-12
3883,1,-22,121,-11,-11
3884,1,13,36,9,4
3885,1,-5,-84,-12,7
3886,1,25,154,14,11
3887,1,14,33,11,3
3888,1,0,-400,20,-20
3889,1,7,-170,17,-10
3890,1,14,33,11,3
3891,1,3,2,1,2
3892,1,18,56,14,4
3893,1,9,20,5,4
3894,1,-7,-170,10,-17
3895,1,-14,13,-13,-1
3896,1,4,0,0,4
3897,1,-9,-36,-12,3
3898,1,8,-209,19,-11
3899,1,-12,20,-2,-10
3900,1,24,135,15,9
3901,1,13,42,6,7
3902,1,33,270,18,15
3903,1,-1,-306,-18,17
3904,1,20,19,1,19
3905,1,11,-102,17,-6
3906,1,24,128,8,16
3907,1,15,26,2,13
3908,1,-8,7,-7,-1
3909,1,-15,0,-15,0
3910,1,-13,-30,-15,2
3911,1,-25,154,-11,-14
3912,1,-17,16,-1,-16
3913,1,-2,-35,5,-7
3914,1,-35,300,-15,-20
3915,1,-9,-70,5,-14
3916,1,4,-60,10,-6
3917,1,-10,-24,-12,2
3918,1,-10,-39,-13,3
3919,1,-12,-160,-20,8
3920,1,17,42,3,14
3921,1,21,38,19,2
3922,1,-4,-192,-16,12
3923,1,-2,0,0,-2
3924,1,2,-24,-4,6
3925,1,-8,-209,-19,11
3926,1,16,63,9,7
3927,1,8,12,2,6
3928,1,7,-78,13,-6
3929,1,16,60,10,6
3930,1,22,72,4,18
3931,1,21,54,3,18
3932,1,-4,-32,4,-8
3933,1,1,-6,-2,3
3934,1,28,195,15,13
3935,1,18,17,1,17
3936,1,-6,-280,-20,14
3937,1,-13,36,-9,-4
3938,1,-20,36,-2,-18
3939,1,-4,3,-1,-3
3940,1,0,-36,-6,6
3941,1,21,80,5,16
3942,1,-2,-24,-6,4
3943,1,-5,-84,7,-12
3944,1,9,-162,-9,18
3945,1,-19,18,-18,-1
3946,1,-4,-165,-15,11
3947,1,3,-270,18,-15
3948,1,-6,-16,-8,2
3949,1,2,-63,9,-7
3950,1,0,-289,-17,17
3951,1,6,5,5,1
3952,1,-8,-209,11,-19
3953,1,-37,340,-20,-17
3954,1,-20,84,-14,-6
3955,1,-20,99,-9,-11
3956,1,7,-44,11,-4
3957,1,-8,15,-5,-3
3958,1,15,-34,-2,17
3959,1,19,84,12,7
3960,1,19,34,17,2
3961,1,-3,-18,-6,3
3962,1,-10,-56,4,-14
3963,1,-24,119,-7,-17
3964,1,-21,98,-14,-7
3965,1,-2,-99,-11,9
3966,1,8,-20,10,-2
3967,1,-7,-198,-18,11
3968,1,16,-36,18,-2
3969,1,12,20,2,10
3970,1,-35,306,-18,-17
3971,1,23,132,11,12
3972,1,-2,-99,9,-11
3973,1,-18,81,-9,-9
3974,1,20,96,12,8
3975,1,-16,63,-7,-9
3976,1,-14,-51,3,-17
3977,1,-14,33,-11,-3
3978,1,6,-187,17,-11
3979,1,14,-32,-2,16
3980,1,0,0,0,0
3981,1,27,176,11,16
3982,1,-28,192,-16,-12
3983,1,16,55,5,11
3984,1,17,70,10,7
3985,1,-24,135,-15,-9
3986,1,-14,-15,1,-15
3987,1,12,-45,15,-3
3988,1,-16,-36,2,-18
3989,1,29,204,17,12
3990,1,-10,-56,4,-14
3991,1,-33,260,-13,-20
3992,1,-14,13,-1,-13
3993,1,-24,80,-4,-20
3994,1,-35,300,-20,-15
3995,1,-10,-96,6,-16
3996,1,2,-15,-3,5
3997,1,-23,130,-10,-13
3998,1,-29,208,-13,-16
3999,1,-20,51,-3,-17
4000,1,-6,-40,-10,4
4001,1,-3,-88,-11,8
4002,1,14,0,0,14
4003,1,14,-51,17,-3
4004,1,29,208,13,16
4005,1,26,120,6,20
4006,1,6,-7,-1,7
4007,1,-24,143,-13,-11
4008,1,38,361,19,19
4009,1,1,-342,-18,19
4010,1,-13,-48,-16,3
4011,1,-23,132,-12,-11
4012,1,8,-180,18,-10
4013,1,2,-99,11,-9
4014,1,31,238,17,14
4015,1,0,-361,-19,19
4016,1,-33,270,-15,-18
4017,1,-9,-190,10,-19
4018,1,-19,70,-5,-14
4019,1,2,-360,-18,20
4020,1,-5,4,-4,-1
4021,1,-18,0,0,-18
4022,1,-11,24,-3,-8
4023,1,-3,-40,5,-8
4024,1,29,210,15,14
4025,1,29,208,13,16
4026,1,15,54,6,9
4027,1,21,20,1,20
4028,1,21,80,16,5
4029,1,35,304,16,19
4030,1,27,170,17,10
4031,1,-13,-140,7,-20
4032,1,-7,-44,4,-11
4033,1,11,10,1,10
4034,1,6,-7,7,-1
4035,1,0,-196,14,-14
4036,1,7,-44,-4,11
4037,1,-20,84,-14,-6
4038,1,7,-198,-11,18
4039,1,-2,-168,12,-14
4040,1,15,50,10,5
4041,1,-22,121,-11,-11
4042,1,-11,-102,6,-17
4043,1,18,77,7,11
4044,1,17,66,6,11
4045,1,12,11,1,11
4046,1,-7,12,-3,-4
4047,1,31,220,11,20
4048,1,4,-221,17,-13
4049,1,8,-105,-7,15
4050,1,-12,27,-9,-3
4051,1,-11,-180,9,-20
4052,1,21,38,19,2
4053,1,11,-152,19,-8
4054,1,-19,78,-13,-6
4055,1,-15,14,-1,-14
4056,1,-28,171,-9,-19
4057,1,13,-114,19,-6
4058,1,7,12,4,3
4059,1,1,-90,10,-9
4060,1,-12,-133,-19,7
4061,1,-21,108,-9,-12
4062,1,6,-40,-4,10
4063,1,39,380,19,20
4064,1,0,-36,6,-6
4065,1,12,36,6,6
4066,1,34,280,20,14
4067,1,-28,187,-17,-11
4068,1,-11,18,-9,-2
4069,1,-12,0,0,-12
4070,1,14,0,0,14
4071,1,-11,-126,-18,7
4072,1,-24,80,-20,-4
4073,1,-5,-234,13,-18
4074,1,18,65,5,13
4075,1,16,-57,19,-3
4076,1,27,182,14,13
4077,1,-6,0,-6,0
4078,1,-25,150,-15,-10
4079,1,-3,-340,-20,17
4080,1,-6,8,-4,-2
4081,1,37,342,19,18
4082,1,28,160,20,8
4083,1,-34,285,-19,-15
4084,1,-21,54,-18,-3
4085,1,2,-143,13,-11
4086,1,-9,14,-7,-2
4087,1,-9,0,-9,0
4088,1,-22,105,-15,-7
4089,1,3,-304,19,-16
4090,1,-3,0,0,-3
4091,1,20,84,14,6
4092,1,-37,342,-18,-19
4093,1,8,-128,16,-8
4094,1,-6,-135,9,-15
4095,1,-9,-136,8,-17
4096,1,3,-88,11,-8
4097,1,-34,288,-18,-16
4098,1,11,-42,-3,14
4099,1,18,32,16,2
4100,1,22,96,16,6
4101,1,1,-56,8,-7
4102,1,-22,121,-11,-11
4103,1,22,120,12,10
4104,1,-29,180,-20,-9
4105,1,14,-95,-5,19
4106,1,7,-260,-13,20
4107,1,-8,7,-7,-1
4108,1,17,52,13,4
4109,1,8,-180,-10,18
4110,1,-34,289,-17,-17
4111,1,-19,70,-14,-5
4112,1,-11,24,-8,-3
4113,1,-16,63,-9,-7
4114,1,-14,-95,5,-19
4115,1,12,-45,15,-3
4116,1,-10,21,-3,-7
4117,1,-30,221,-13,-17
4118,1,-7,-198,11,-18
4119,1,13,-30,-2,15
4120,1,-34,289,-17,-17
4121,1,13,0,0,13
4122,1,2,-323,-17,19
4123,1,-22,117,-13,-9
4124,1,-18,-40,-20,2
4125,1,-6,-216,12,-18
4126,1,-11,-180,-20,9
4127,1,-13,30,-10,-3
4128,1,26,120,6,20
4129,1,-3,-40,-8,5
4130,1,7,-260,-13,20
4131,1,4,-32,-4,8
4132,1,-18,-19,1,-19
4133,1,-17,52,-13,-4
4134,1,-21,38,-19,-2
4135,1,-12,-85,5,-17
4136,1,-10,-24,2,-12
4137,1,-6,-280,14,-20
4138,1,9,-90,15,-6
4139,1,-12,-108,6,-18
4140,1,-21,98,-14,-7
4141,1,16,28,14,2
4142,1,-38,361,-19,-19
4143,1,-10,25,-5,-5
4144,1,10,-96,-6,16
4145,1,-14,-120,6,-20
4146,1,-31,240,-16,-15
4147,1,-30,200,-10,-20
4148,1,17,0,0,17
4149,1,21,20,20,1
4150,1,0,-81,9,-9
4151,1,-11,-126,-18,7
4152,1,-30,225,-15,-15
4153,1,-40,400,-20,-20
4154,1,-13,-114,-19,6
4155,1,-8,-209,-19,11
4156,1,18,0,0,18
4157,1,-7,0,0,-7
4158,1,26,133,19,7
4159,1,25,156,13,12
4160,1,-14,-51,-17,3
4161,1,13,42,6,7
4162,1,0,-64,8,-8
4163,1,15,14,1,14
4164,1,36,320,16,20
4165,1,12,-85,17,-5
4166,1,10,-24,12,-2
4167,1,-22,112,-14,-8
4168,1,-27,162,-9,-18
4169,1,35,300,15,20
4170,1,-15,54,-9,-6
4171,1,-3,-18,-6,3
4172,1,12,11,1,11
4173,1,0,-49,7,-7
4174,1,0,-4,2,-2
4175,1,-29,204,-12,-17
4176,1,-10,-144,-18,8
4177,1,-15,36,-3,-12
4178,1,13,-90,18,-5
4179,1,1,0,0,1
4180,1,1,-306,-17,18
4181,1,22,117,13,9
4182,1,19,48,16,3
4183,1,-17,-60,3,-20
4184,1,1,-156,13,-12
4185,1,-11,-180,-20,9
4186,1,3,-340,-17,20
4187,1,-25,156,-12,-13
4188,1,-24,80,-4,-20
4189,1,3,-270,-15,18
4190,1,10,21,3,7
4191,1,6,-135,15,-9
4192,1,-8,-48,4,-12
4193,1,16,28,14,2
4194,1,25,150,15,10
4195,1,-30,216,-12,-18
4196,1,23,120,8,15
4197,1,-17,60,-12,-5
4198,1,2,-63,-7,9
4199,1,10,9,9,1
4200,1,11,-126,-7,18
4201,1,-5,-66,6,-11
4202,1,-11,18,-9,-2
4203,1,5,-176,-11,16
4204,1,-12,-64,-16,4
4205,1,-27,152,-19,-8
4206,1,9,18,6,3
4207,1,15,26,13,2
4208,1,-11,-12,1,-12
4209,1,-23,90,-18,-5
4210,1,22,85,5,17
4211,1,25,114,6,19
4212,1,3,-180,15,-12
4213,1,-18,32,-16,-2
4214,1,9,-90,15,-6
4215,1,12,0,12,0
4216,1,-7,-120,8,-15
4217,1,-13,-30,-15,2
4218,1,-9,-10,1,-10
4219,1,10,9,9,1
4220,1,22,72,4,18
4221,1,-33,266,-14,-19
4222,1,2,-35,7,-5
4223,1,-11,-180,9,-20
4224,1,0,-196,-14,14
4225,1,25,156,13,12
4226,1,-14,-72,-18,4
4227,1,-2,-48,-8,6
4228,1,-34,285,-15,-19
4229,1,-20,84,-6,-14
4230,1,3,-28,7,-4
4231,1,1,-306,-17,18
4232,1,-3,2,-1,-2
4233,1,-9,14,-2,-7
4234,1,-33,270,-15,-18
4235,1,10,-56,14,-4
4236,1,-11,-152,-19,8
4237,1,0,-1,1,-1
4238,1,28,187,11,17
4239,1,3,-88,-8,11
4240,1,14,40,10,4
4241,1,19,88,8,11
4242,1,-10,24,-6,-4
4243,1,15,-16,16,-1
4244,1,-23,120,-15,-8
4245,1,-10,21,-3,-7
4246,1,-14,45,-5,-9
4247,1,-1,-90,-10,9
4248,1,19,48,3,16
4249,1,0,-289,-17,17
4250,1,15,-54,18,-3
4251,1,23,126,9,14
4252,1,-7,-44,-11,4
4253,1,8,-128,-8,16
4254,1,35,304,16,19
4255,1,12,-28,-2,14
4256,1,-26,165,-11,-15
4257,1,5,-6,6,-1
4258,1,-5,-234,13,-18
4259,1,16,-80,-4,20
4260,1,-9,-36,3,-12
4261,1,14,-32,16,-2
4262,1,7,-260,-13,20
4263,1,-3,0,-3,0
4264,1,15,0,0,15
4265,1,-8,-20,2,-10
4266,1,29,198,11,18
4267,1,-3,-304,-19,16
4268,1,11,-180,-9,20
4269,1,4,-117,-9,13
4270,1,-20,36,-18,-2
4271,1,-17,-60,-20,3
4272,1,-35,304,-19,-16
4273,1,-8,-9,1,-9
4274,1,11,10,1,10
4275,1,-16,63,-9,-7
4276,1,-17,60,-5,-12
4277,1,9,-162,18,-9
4278,1,-7,12,-3,-4
4279,1,22,112,14,8
4280,1,-18,-40,2,-20
4281,1,12,-64,16,-4
4282,1,2,-120,12,-10
4283,1,19,84,7,12
4284,1,20,19,19,1
4285,1,33,260,13,20
4286,1,-36,323,-17,-19
4287,1,6,-280,20,-14
4288,1,-4,-77,-11,7
4289,1,29,204,12,17
4290,1,11,-42,-3,14
4291,1,17,52,4,13
4292,1,-8,-180,-18,10
4293,1,11,10,10,1
4294,1,-24,140,-14,-10
4295,1,-4,-285,15,-19
4296,1,12,27,3,9
4297,1,-5,-176,-16,11
4298,1,20,64,4,16
4299,1,-24,143,-11,-13
4300,1,32,255,15,17
4301,1,15,0,15,0
4302,1,-5,-50,-10,5
4303,1,-10,-56,-14,4
4304,1,25,126,7,18
4305,1,13,0,13,0
4306,1,4,-77,11,-7
4307,1,-26,165,-11,-15
4308,1,-9,-10,1,-10
4309,1,-22,105,-15,-7
4310,1,-22,85,-17,-5
4311,1,-7,-78,6,-13
4312,1,-28,171,-9,-19
4313,1,7,0,0,7
4314,1,-3,-4,1,-4
4315,1,-3,-154,11,-14
4316,1,-8,-33,-11,3
4317,1,-1,-30,5,-6
4318,1,1,-56,8,-7
4319,1,11,-102,-6,17
4320,1,31,234,18,13
4321,1,0,-81,9,-9
4322,1,3,-154,14,-11
4323,1,-2,-224,-16,14
4324,1,23,60,20,3
4325,1,12,-64,-4,16
4326,1,33,272,17,16
4327,1,10,-56,-4,14
4328,1,-4,-45,-9,5
4329,1,-9,-112,-16,7
4330,1,1,-20,-4,5
4331,1,12,-108,18,-6
4332,1,17,-38,19,-2
4333,1,3,-40,-5,8
4334,1,-8,0,0,-8
4335,1,28,196,14,14
4336,1,24,143,11,13
4337,1,20,36,2,18
4338,1,-3,-70,7,-10
4339,1,17,60,5,12
4340,1,-21,20,-1,-20
4341,1,3,-4,-1,4
4342,1,7,-198,18,-11
4343,1,2,-3,-1,3
4344,1,-20,75,-15,-5
4345,1,19,60,15,4
4346,1,12,-133,-7,19
4347,1,-27,180,-15,-12
4348,1,-19,60,-15,-4
4349,1,20,84,14,6
4350,1,9,-112,16,-7
4351,1,3,-18,-3,6
4352,1,-25,154,-11,-14
4353,1,-16,-80,-20,4
4354,1,-18,32,-16,-2
4355,1,27,180,12,15
4356,1,-37,340,-17,-20
4357,1,0,-81,9,-9
4358,1,8,-84,-6,14
4359,1,-3,-304,-19,16
4360,1,-7,10,-5,-2
4361,1,28,195,13,15
4362,1,11,30,5,6
4363,1,4,3,1,3
4364,1,0,-100,10,-10
4365,1,-12,20,-10,-2
4366,1,15,-100,20,-5
4367,1,20,96,8,12
4368,1,-9,-36,-12,3
4369,1,16,-80,20,-4
4370,1,7,0,7,0
4371,1,-14,40,-10,-4
4372,1,8,-240,20,-12
4373,1,23,132,12,11
4374,1,-28,160,-20,-8
4375,1,5,0,5,0
4376,1,0,-25,-5,5
4377,1,9,-162,18,-9
4378,1,11,-42,-3,14
4379,1,13,36,9,4
4380,1,2,-24,6,-4
4381,1,0,-196,-14,14
4382,1,-13,-30,-15,2
4383,1,14,0,0,14
4384,1,-3,-28,4,-7
4385,1,-10,-56,4,-14
4386,1,-14,-72,-18,4
4387,1,-12,-45,-15,3
4388,1,4,-285,19,-15
4389,1,19,34,17,2
4390,1,5,0,0,5
4391,1,11,-180,-9,20
4392,1,2,-288,18,-16
4393,1,-4,-192,-16,12
4394,1,21,20,20,1
4395,1,-19,0,0,-19
4396,1,-1,-306,-18,17
4397,1,17,-38,-2,19
4398,1,-9,-162,9,-18
4399,1,-8,-48,4,-12
4400,1,-14,-120,-20,6
4401,1,-17,16,-1,-16
4402,1,-9,-90,6,-15
4403,1,-32,240,-12,-20
4404,1,-8,-20,-10,2
4405,1,-7,-30,-10,3
4406,1,1,-6,-2,3
4407,1,6,5,5,1
4408,1,-29,198,-18,-11
4409,1,28,171,9,19
4410,1,-27,170,-10,-17
4411,1,-4,-140,-14,10
4412,1,-22,96,-6,-16
4413,1,2,-120,-10,12
4414,1,-18,80,-10,-8
4415,1,-16,0,-16,0
4416,1,12,-64,-4,16
4417,1,10,-24,-2,12
4418,1,25,156,13,12
4419,1,12,11,11,1
4420,1,-16,-57,3,-19
4421,1,-7,6,-1,-6
4422,1,-3,-154,-14,11
4423,1,-10,0,-10,0
4424,1,8,0,0,8
4425,1,1,-2,2,-1
4426,1,17,72,9,8
4427,1,-5,-50,-10,5
4428,1,32,247,13,19
4429,1,1,-20,5,-4
4430,1,-10,-24,2,-12
4431,1,16,0,16,0
4432,1,-23,90,-18,-5
4433,1,16,-57,-3,19
4434,1,4,-60,10,-6
4435,1,0,-196,-14,14
4436,1,1,-380,20,-19
4437,1,8,-33,11,-3
4438,1,19,70,5,14
4439,1,17,30,15,2
4440,1,-7,-260,-20,13
4441,1,-4,-60,-10,6
4442,1,2,-120,-10,12
4443,1,5,-24,-3,8
4444,1,9,-112,16,-7
4445,1,-27,152,-19,-8
4446,1,22,112,8,14
4447,1,-9,-10,1,-10
4448,1,1,-2,-1,2
4449,1,4,-77,-7,11
4450,1,-11,-180,9,-20
4451,1,-19,18,-18,-1
4452,1,18,-19,19,-1
4453,1,17,66,11,6
4454,1,-7,-60,5,-12
4455,1,0,-225,-15,15
4456,1,-8,-9,-9,1
4457,1,-3,-18,-6,3
4458,1,4,-140,-10,14
4459,1,23,102,17,6
4460,1,10,24,4,6
4461,1,3,-340,20,-17
4462,1,-21,20,-20,-1
4463,1,-8,-209,11,-19
4464,1,-2,-255,-17,15
4465,1,-18,72,-6,-12
4466,1,-21,110,-11,-10
4467,1,34,288,18,16
4468,1,-3,-88,-11,8
4469,1,-10,-171,9,-19
4470,1,2,-8,-2,4
4471,1,-19,0,-19,0
4472,1,19,48,16,3
4473,1,-16,28,-14,-2
4474,1,-10,24,-4,-6
4475,1,-14,48,-8,-6
4476,1,18,80,10,8
4477,1,5,-66,11,-6
4478,1,-34,288,-18,-16
4479,1,-13,30,-10,-3
4480,1,13,-48,-3,16
4481,1,32,247,19,13
4482,1,40,400,20,20
4483,1,11,-12,-1,12
4484,1,-10,-39,3,-13
4485,1,-4,-96,-12,8
4486,1,-24,119,-7,-17
4487,1,30,221,13,17
4488,1,-30,209,-19,-11
4489,1,-14,48,-6,-8
4490,1,-12,20,-2,-10
4491,1,2,-323,-17,19
4492,1,24,135,9,15
4493,1,5,-204,-12,17
4494,1,-11,-102,-17,6
4495,1,20,0,20,0
4496,1,-11,-180,-20,9
4497,1,12,35,5,7
4498,1,-15,36,-3,-12
4499,1,30,224,16,14
4500,1,3,2,1,2
4501,1,18,0,18,0
4502,1,19,90,10,9
4503,1,-8,-153,9,-17
4504,1,4,-21,7,-3
4505,1,-14,13,-1,-13
4506,1,-13,0,-13,0
4507,1,2,-15,5,-3
4508,1,-18,72,-12,-6
4509,1,-1,-56,7,-8
4510,1,-19,48,-3,-16
4511,1,9,18,3,6
4512,1,-19,84,-12,-7
4513,1,7,12,3,4
4514,1,-11,-26,-13,2
4515,1,26,160,10,16
4516,1,-17,16,-1,-16
4517,1,5,6,2,3
4518,1,9,-190,-10,19
4519,1,2,-224,-14,16
4520,1,19,78,13,6
4521,1,2,-255,-15,17
4522,1,4,-21,7,-3
4523,1,-13,0,-13,0
4524,1,9,-36,12,-3
4525,1,-25,126,-18,-7
4526,1,-3,-304,16,-19
4527,1,-8,-20,-10,2
4528,1,-18,0,0,-18
4529,1,-1,-210,-15,14
4530,1,-9,-190,10,-19
4531,1,17,16,1,16
4532,1,-15,26,-2,-13
4533,1,-13,-140,-20,7
4534,1,-14,-51,3,-17
4535,1,0,-1,1,-1
4536,1,6,-135,-9,15
4537,1,-8,-84,-14,6
4538,1,3,-340,20,-17
4539,1,-7,-170,-17,10
4540,1,-12,-133,-19,7
4541,1,2,-224,16,-14
4542,1,-20,100,-10,-10
4543,1,22,85,5,17
4544,1,30,200,10,20
4545,1,30,200,10,20
4546,1,-17,52,-13,-4
4547,1,3,-10,5,-2
4548,1,17,16,16,1
4549,1,7,-170,-10,17
4550,1,-24,135,-15,-9
4551,1,20,99,9,11
4552,1,2,-99,11,-9
4553,1,1,-2,2,-1
4554,1,-5,-300,15,-20
4555,1,38,361,19,19
4556,1,2,-35,7,-5
4557,1,1,-30,-5,6
4558,1,20,64,16,4
4559,1,-6,-112,8,-14
4560,1,-8,-84,-14,6
4561,1,10,-144,-8,18
4562,1,35,306,18,17
4563,1,-4,-32,-8,4
4564,1,2,-255,-15,17
4565,1,-24,140,-14,-10
4566,1,0,-16,4,-4
4567,1,-21,38,-2,-19
4568,1,10,-11,-1,11
4569,1,27,176,16,11
4570,1,-16,28,-14,-2
4571,1,-23,112,-7,-16
4572,1,14,48,6,8
4573,1,-6,-27,3,-9
4574,1,5,-6,6,-1
4575,1,-6,-247,-19,13
4576,1,-16,55,-5,-11
4577,1,8,12,6,2
4578,1,5,-6,-1,6
4579,1,-10,9,-1,-9
4580,1,-6,-112,-14,8
4581,1,4,-77,-7,11
4582,1,-18,65,-13,-5
4583,1,22,120,10,12
4584,1,7,-144,16,-9
4585,1,9,8,1,8
4586,1,-21,54,-3,-18
4587,1,-7,-78,-13,6
4588,1,15,36,12,3
4589,1,-7,-98,7,-14
4590,1,19,34,17,2
4591,1,8,-9,-1,9
4592,1,27,180,12,15
4593,1,-35,304,-16,-19
4594,1,-3,-40,-8,5
4595,1,21,98,14,7
4596,1,1,-156,13,-12
4597,1,-11,-126,7,-18
4598,1,-17,72,-9,-8
4599,1,-11,-80,5,-16
4600,1,17,-38,19,-2
4601,1,-37,340,-20,-17
4602,1,38,361,19,19
4603,1,14,-51,-3,17
4604,1,-4,-285,15,-19
4605,1,35,306,17,18
4606,1,3,-340,20,-17
4607,1,-17,0,-17,0
4608,1,-19,0,0,-19
4609,1,-19,48,-3,-16
4610,1,-23,60,-3,-20
4611,1,-8,-20,-10,2
4612,1,2,-48,-6,8
4613,1,10,-200,-10,20
4614,1,6,-91,13,-7
4615,1,-2,-360,-20,18
4616,1,4,-96,12,-8
4617,1,-15,-76,-19,4
4618,1,19,18,1,18
4619,1,25,136,8,17
4620,1,19,-20,-1,20
4621,1,17,30,15,2
4622,1,27,170,10,17
4623,1,-23,76,-19,-4
4624,1,-7,-60,-12,5
4625,1,15,14,14,1
4626,1,31,238,14,17
4627,1,4,-96,12,-8
4628,1,11,-12,-1,12
4629,1,-12,27,-3,-9
4630,1,10,-56,-4,14
4631,1,19,18,1,18
4632,1,-6,-27,-9,3
4633,1,20,99,11,9
4634,1,-26,160,-10,-16
4635,1,23,126,9,14
4636,1,-9,20,-5,-4
4637,1,-13,40,-8,-5
4638,1,4,0,4,0
4639,1,24,95,5,19
4640,1,20,96,8,12
4641,1,7,-30,10,-3
4642,1,-16,-36,-18,2
4643,1,-4,-32,-8,4
4644,1,8,-65,13,-5
4645,1,-13,12,-12,-1
4646,1,-8,-209,-19,11
4647,1,23,76,4,19
4648,1,-17,-38,2,-19
4649,1,-27,182,-13,-14
4650,1,9,-70,14,-5
4651,1,-23,60,-20,-3
4652,1,24,119,7,17
4653,1,-35,306,-17,-18
4654,1,16,-17,17,-1
4655,1,-34,288,-16,-18
4656,1,-6,-187,-17,11
4657,1,17,0,0,17
4658,1,17,30,15,2
4659,1,10,-56,14,-4
4660,1,8,-65,13,-5
4661,1,6,9,3,3
4662,1,-32,247,-13,-19
4663,1,-1,-306,-18,17
4664,1,-2,-24,4,-6
4665,1,-22,40,-20,-2
4666,1,-5,-14,2,-7
4667,1,-36,324,-18,-18
4668,1,24,108,18,6
4669,1,-20,75,-15,-5
4670,1,24,140,10,14
4671,1,4,3,1,3
4672,1,-9,-22,-11,2
4673,1,-7,-228,12,-19
4674,1,14,45,9,5
4675,1,1,-272,17,-16
4676,1,9,-162,18,-9
4677,1,3,-10,-2,5
4678,1,-30,200,-10,-20
4679,1,-7,-260,-20,13
4680,1,-10,-24,2,-12
4681,1,-2,-255,-17,15
4682,1,22,40,2,20
4683,1,30,221,17,13
4684,1,13,-140,20,-7
4685,1,6,-160,-10,16
4686,1,15,-76,-4,19
4687,1,15,56,8,7
4688,1,-6,-160,10,-16
4689,1,-33,260,-13,-20
4690,1,25,136,8,17
4691,1,-2,-24,4,-6
4692,1,21,98,14,7
4693,1,-16,-57,3,-19
4694,1,-3,-18,3,-6
4695,1,-16,-17,1,-17
4696,1,30,216,12,18
4697,1,11,-26,-2,13
4698,1,10,-24,12,-2
4699,1,-9,-136,8,-17
4700,1,15,-54,18,-3
4701,1,-10,-11,1,-11
4702,1,27,176,16,11
4703,1,-11,-80,5,-16
4704,1,-3,-88,-11,8
4705,1,-34,280,-14,-20
4706,1,9,-36,-3,12
4707,1,1,-272,-16,17
4708,1,17,0,17,0
4709,1,-1,-380,19,-20
4710,1,12,36,6,6
4711,1,-28,195,-13,-15
4712,1,8,-33,11,-3
4713,1,7,-170,-10,17
4714,1,1,-240,16,-15
4715,1,-30,209,-19,-11
4716,1,7,6,6,1
4717,1,-11,30,-5,-6
4718,1,-1,-380,19,-20
4719,1,-4,-21,3,-7
4720,1,22,105,15,7
4721,1,-24,140,-14,-10
4722,1,13,22,2,11
4723,1,-3,-304,-19,16
4724,1,-19,48,-16,-3
4725,1,1,-20,5,-4
4726,1,24,135,15,9
4727,1,6,-280,20,-14
4728,1,-13,-114,6,-19
4729,1,-1,-2,1,-2
4730,1,33,272,17,16
4731,1,36,324,18,18
4732,1,-21,108,-9,-12
4733,1,-14,-120,6,-20
4734,1,33,272,16,17
4735,1,-1,-20,-5,4
4736,1,5,4,4,1
4737,1,-2,-63,7,-9
4738,1,-5,-14,-7,2
4739,1,27,170,10,17
4740,1,-4,-32,4,-8
4741,1,3,-238,-14,17
4742,1,23,102,17,6
4743,1,-5,-104,-13,8
4744,1,-26,120,-20,-6
4745,1,10,-144,-8,18
4746,1,-1,-380,19,-20
4747,1,-12,32,-4,-8
4748,1,-6,-112,-14,8
4749,1,-15,-100,5,-20
4750,1,-4,-285,-19,15
4751,1,-4,-192,12,-16
4752,1,7,-30,10,-3
4753,1,4,-140,14,-10
4754,1,23,90,5,18
4755,1,-11,-152,-19,8
4756,1,-9,-52,4,-13
4757,1,12,35,7,5
4758,1,-4,-32,-8,4
4759,1,-14,45,-5,-9
4760,1,-15,56,-8,-7
4761,1,-27,180,-15,-12
4762,1,4,-252,18,-14
4763,1,2,-8,-2,4
4764,1,-18,-40,2,-20
4765,1,10,-75,15,-5
4766,1,24,95,5,19
4767,1,2,-3,3,-1
4768,1,35,300,20,15
4769,1,38,361,19,19
4770,1,34,285,19,15
4771,1,5,-176,-11,16
4772,1,17,30,2,15
4773,1,17,72,9,8
4774,1,-3,-28,4,-7
4775,1,6,8,4,2
4776,1,6,5,1,5
4777,1,-8,-65,-13,5
4778,1,12,-64,16,-4
4779,1,17,-60,20,-3
4780,1,-21,108,-9,-12
4781,1,19,88,11,8
4782,1,8,-209,19,-11
4783,1,-5,-36,4,-9
4784,1,-25,144,-9,-16
4785,1,-5,-6,-6,1
4786,1,-34,288,-16,-18
4787,1,-11,18,-2,-9
4788,1,-12,-64,4,-16
4789,1,-4,-5,1,-5
4790,1,-2,-48,6,-8
4791,1,11,-126,-7,18
4792,1,-27,176,-16,-11
4793,1,-24,80,-20,-4
4794,1,-6,-280,-20,14
4795,1,-28,160,-20,-8
4796,1,14,-15,-1,15
4797,1,5,-150,15,-10
4798,1,-23,60,-20,-3
4799,1,8,15,3,5
4800,1,-11,-180,9,-20
4801,1,-36,323,-19,-17
4802,1,27,180,15,12
4803,1,16,-17,17,-1
4804,1,-19,34,-17,-2
4805,1,-1,-272,-17,16
4806,1,0,-25,5,-5
4807,1,14,40,10,4
4808,1,9,-10,10,-1
4809,1,17,-38,19,-2
4810,1,-1,-182,13,-14
4811,1,-1,-56,7,-8
4812,1,30,224,16,14
4813,1,13,-14,-1,14
4814,1,5,-234,18,-13
4815,1,-25,136,-17,-8
4816,1,19,18,1,18
4817,1,23,120,8,15
4818,1,-13,12,-12,-1
4819,1,25,154,14,11
4820,1,-1,-306,-18,17
4821,1,-11,-126,-18,7
4822,1,5,-24,-3,8
4823,1,-19,70,-14,-5
4824,1,-29,210,-15,-14
4825,1,-4,-252,14,-18
4826,1,-3,-304,16,-19
4827,1,-26,153,-17,-9
4828,1,-3,-18,3,-6
4829,1,25,114,19,6
4830,1,-21,68,-17,-4
4831,1,29,208,16,13
4832,1,-9,18,-6,-3
4833,1,4,-117,13,-9
4834,1,12,-13,13,-1
4835,1,12,-45,15,-3
4836,1,19,0,0,19
4837,1,9,8,1,8
4838,1,28,196,14,14
4839,1,4,-192,16,-12
4840,1,1,-132,-11,12
4841,1,25,100,5,20
4842,1,21,68,17,4
4843,1,27,176,16,11
4844,1,-8,-105,7,-15
4845,1,-15,26,-2,-13
4846,1,7,-260,-13,20
4847,1,-2,-224,14,-16
4848,1,17,0,17,0
4849,1,3,-180,-12,15
4850,1,-5,-36,4,-9
4851,1,-11,0,0,-11
4852,1,1,-342,-18,19
4853,1,5,-14,-2,7
4854,1,-27,140,-20,-7
4855,1,8,-20,10,-2
4856,1,5,-126,14,-9
4857,1,-17,70,-10,-7
4858,1,-29,198,-11,-18
4859,1,28,160,20,8
4860,1,9,8,8,1
4861,1,0,-9,3,-3
4862,1,10,21,3,7
4863,1,22,57,19,3
4864,1,-9,18,-3,-6
4865,1,-14,-15,-15,1
4866,1,9,-10,-1,10
4867,1,5,-66,11,-6
4868,1,-15,26,-2,-13
4869,1,8,15,5,3
4870,1,11,10,1,10
4871,1,27,176,11,16
4872,1,26,165,15,11
4873,1,-6,-40,4,-10
4874,1,-6,-27,3,-9
4875,1,-5,-204,-17,12
4876,1,-19,48,-16,-3
4877,1,-23,126,-9,-14
4878,1,4,-96,-8,12
4879,1,2,-168,-12,14
4880,1,-36,323,-19,-17
4881,1,-15,36,-12,-3
4882,1,36,320,16,20
4883,1,33,270,18,15
4884,1,22,85,5,17
4885,1,-1,-272,16,-17
4886,1,20,96,12,8
4887,1,27,152,8,19
4888,1,-6,-280,14,-20
4889,1,9,-22,-2,11
4890,1,-32,247,-13,-19
4891,1,-19,48,-3,-16
4892,1,-37,342,-18,-19
4893,1,-1,-156,-13,12
4894,1,-5,-204,12,-17
4895,1,-13,0,-13,0
4896,1,0,-324,-18,18
4897,1,6,-55,-5,11
4898,1,-11,-180,9,-20
4899,1,3,-10,-2,5
4900,1,5,-36,9,-4
4901,1,-30,216,-12,-18
4902,1,0,-256,16,-16
4903,1,-7,10,-5,-2
4904,1,31,220,20,11
4905,1,-7,0,-7,0
4906,1,-5,-104,8,-13
4907,1,17,-60,20,-3
4908,1,3,-340,-17,20
4909,1,28,192,12,16
4910,1,24,119,7,17
4911,1,7,-8,-1,8
4912,1,8,-128,16,-8
4913,1,-1,-182,13,-14
4914,1,-30,216,-18,-12
4915,1,-2,-195,13,-15
4916,1,-28,192,-12,-16
4917,1,-13,-14,-14,1
4918,1,18,-19,-1,19
4919,1,-7,0,0,-7
4920,1,-6,-247,-19,13
4921,1,32,255,17,15
4922,1,8,-105,-7,15
4923,1,-3,0,0,-3
4924,1,0,-64,-8,8
4925,1,-4,-252,-18,14
4926,1,-5,-176,11,-16
4927,1,29,210,14,15
4928,1,24,144,12,12
4929,1,-20,0,0,-20
4930,1,34,280,20,14
4931,1,-7,-30,-10,3
4932,1,15,54,9,6
4933,1,3,-54,9,-6
4934,1,7,-120,-8,15
4935,1,5,-266,19,-14
4936,1,19,-20,-1,20
4937,1,-23,130,-10,-13
4938,1,4,-165,15,-11
4939,1,-10,-39,-13,3
4940,1,-5,-50,5,-10
4941,1,-25,100,-20,-5
4942,1,24,135,9,15
4943,1,-3,2,-1,-2
4944,1,-35,306,-18,-17
4945,1,-25,126,-18,-7
4946,1,2,1,1,1
4947,1,-16,0,-16,0
4948,1,20,19,19,1
4949,1,14,40,4,10
4950,1,-6,-91,7,-13
4951,1,-4,-117,-13,9
4952,1,-5,-204,12,-17
4953,1,-4,-60,-10,6
4954,1,1,-110,-10,11
4955,1,-1,-380,19,-20
4956,1,0,-49,-7,7
4957,1,17,-18,18,-1
4958,1,-22,105,-7,-15
4959,1,-1,-210,-15,14
4960,1,-33,266,-14,-19
4961,1,-13,42,-7,-6
4962,1,-2,-288,-18,16
4963,1,18,0,0,18
4964,1,13,-68,-4,17
4965,1,15,-54,18,-3
4966,1,-3,-10,-5,2
4967,1,3,0,3,0
4968,1,15,-16,16,-1
4969,1,18,80,10,8
4970,1,13,-14,14,-1
4971,1,-19,70,-14,-5
4972,1,14,13,1,13
4973,1,-22,72,-18,-4
4974,1,27,176,11,16
4975,1,8,-153,-9,17
4976,1,7,-60,-5,12
4977,1,10,-144,-8,18
4978,1,-14,33,-11,-3
4979,1,-22,96,-6,-16
4980,1,0,-169,-13,13
4981,1,-25,150,-10,-15
4982,1,-5,4,-4,-1
4983,1,19,60,15,4
4984,1,-37,340,-20,-17
4985,1,-16,39,-13,-3
4986,1,-4,-165,11,-15
4987,1,-7,-18,2,-9
4988,1,-12,-45,3,-15
4989,1,-25,136,-8,-17
4990,1,6,9,3,3
4991,1,9,14,7,2
4992,1,6,-216,18,-12
4993,1,17,-18,-1,18
4994,1,17,42,14,3
4995,1,-27,176,-11,-16
4996,1,-11,-80,-16,5
4997,1,6,0,6,0
4998,1,-11,-126,7,-18
4999,1,-21,110,-11,-10
5000,1,29,208,16,13
5001,1,-14,49,-7,-7
5002,1,-8,-20,-10,2
5003,1,4,-60,10,-6
5004,1,21,54,18,3
5005,1,1,0,1,0
5006,1,-4,-165,11,-15
5007,1,7,-18,9,-2
5008,1,19,88,8,11
5009,1,24,128,16,8
5010,1,-25,144,-16,-9
5011,1,23,132,12,11
5012,1,35,304,19,16
5013,1,4,0,0,4
5014,1,-14,-120,6,-20
5015,1,2,-3,-1,3
5016,1,23,90,5,18
5017,1,32,240,20,12
5018,1,-19,34,-2,-17
5019,1,17,-38,19,-2
5020,1,-16,15,-15,-1
5021,1,10,-200,20,-10
5022,1,-13,40,-8,-5
5023,1,13,-68,-4,17
5024,1,-26,160,-16,-10
5025,1,-19,34,-17,-2
5026,1,7,-170,-10,17
5027,1,-29,198,-11,-18
5028,1,4,-45,9,-5
5029,1,-14,33,-11,-3
5030,1,7,-18,9,-2
5031,1,-32,255,-15,-17
5032,1,-29,210,-15,-14
5033,1,8,-180,-10,18
5034,1,-3,0,-3,0
5035,1,7,-44,11,-4
5036,1,2,-168,14,-12
5037,1,-2,-255,-17,15
5038,1,9,18,6,3
5039,1,30,200,10,20
5040,1,-35,300,-15,-20
5041,1,-2,-48,-8,6
5042,1,-34,285,-15,-19
5043,1,7,6,6,1
5044,1,9,-22,11,-2
5045,1,16,39,3,13
5046,1,40,400,20,20
5047,1,-8,-105,7,-15
5048,1,-29,210,-15,-14
5049,1,24,144,12,12
5050,1,-19,34,-2,-17
5051,1,-7,10,-2,-5
5052,1,9,-22,11,-2
5053,1,-7,-260,13,-20
5054,1,14,49,7,7
5055,1,-32,247,-19,-13
5056,1,12,-85,-5,17
5057,1,26,153,17,9
5058,1,-28,196,-14,-14
5059,1,-16,-57,-19,3
5060,1,-21,104,-8,-13
5061,1,4,-96,-8,12
5062,1,40,400,20,20
5063,1,5,-204,-12,17
5064,1,-24,128,-16,-8
5065,1,5,-176,-11,16
5066,1,33,270,15,18
5067,1,4,-21,-3,7
5068,1,-16,-17,-17,1
5069,1,16,-80,20,-4
5070,1,-5,-126,-14,9
5071,1,30,200,20,10
5072,1,-17,60,-12,-5
5073,1,5,-204,-12,17
5074,1,-17,70,-10,-7
5075,1,-2,-8,-4,2
5076,1,-1,-182,-14,13
5077,1,34,285,19,15
5078,1,37,340,17,20
5079,1,3,-180,-12,15
5080,1,19,70,14,5
5081,1,3,-18,6,-3
5082,1,30,225,15,15
5083,1,-31,240,-15,-16
5084,1,-16,60,-10,-6
5085,1,-2,-48,-8,6
5086,1,-19,0,-19,0
5087,1,15,44,4,11
5088,1,-2,-323,17,-19
5089,1,-6,9,-3,-3
5090,1,-3,2,-2,-1
5091,1,5,6,2,3
5092,1,27,152,8,19
5093,1,-20,96,-12,-8
5094,1,-12,-13,-13,1
5095,1,2,-288,18,-16
5096,1,-19,88,-8,-11
5097,1,38,360,20,18
5098,1,25,144,16,9
5099,1,-2,-168,-14,12
5100,1,36,323,17,19
5101,1,25,150,10,15
5102,1,7,10,2,5
5103,1,-5,-24,-8,3
5104,1,8,-20,-2,10
5105,1,-7,12,-4,-3
5106,1,26,133,19,7
5107,1,9,-36,12,-3
5108,1,21,80,16,5
5109,1,-14,40,-10,-4
5110,1,-11,-152,-19,8
5111,1,11,-180,20,-9
5112,1,22,72,18,4
5113,1,-9,0,0,-9
5114,1,-6,-280,14,-20
5115,1,31,238,17,14
5116,1,-10,0,0,-10
5117,1,-14,45,-5,-9
5118,1,27,176,11,16
5119,1,-17,70,-10,-7
5120,1,7,10,5,2
5121,1,1,-90,10,-9
5122,1,5,-84,-7,12
5123,1,-29,180,-20,-9
5124,1,11,28,7,4
5125,1,-6,-216,-18,12
5126,1,-13,22,-11,-2
5127,1,-15,-76,4,-19
5128,1,-18,80,-10,-8
5129,1,17,42,3,14
5130,1,-13,30,-3,-10
5131,1,0,-49,-7,7
5132,1,6,-247,-13,19
5133,1,-4,-320,16,-20
5134,1,23,126,14,9
5135,1,31,228,12,19
5136,1,30,224,16,14
5137,1,2,-80,-8,10
5138,1,-4,3,-3,-1
5139,1,-19,88,-11,-8
5140,1,-15,-34,2,-17
5141,1,2,-360,-18,20
5142,1,20,99,11,9
5143,1,-22,85,-17,-5
5144,1,12,-108,-6,18
5145,1,-18,45,-15,-3
5146,1,-3,-130,10,-13
5147,1,8,-209,19,-11
5148,1,7,-18,9,-2
5149,1,-2,-3,-3,1
5150,1,-28,192,-12,-16
5151,1,6,-216,-12,18
5152,1,-16,28,-2,-14
5153,1,12,-85,17,-5
5154,1,27,180,15,12
5155,1,8,0,8,0
5156,1,-12,-45,-15,3
5157,1,-6,-187,11,-17
5158,1,-6,-40,-10,4
5159,1,-24,80,-4,-20
5160,1,7,12,3,4
5161,1,-22,57,-3,-19
5162,1,37,342,18,19
5163,1,-13,36,-9,-4
5164,1,14,-72,-4,18
5165,1,3,-10,5,-2
5166,1,25,136,8,17
5167,1,22,85,5,17
5168,1,-9,-10,-10,1
5169,1,-29,204,-12,-17
5170,1,-9,-70,5,-14
5171,1,-14,33,-3,-11
5172,1,7,-78,-6,13
5173,1,12,-133,19,-7
5174,1,-19,18,-1,-18
5175,1,-8,-65,-13,5
5176,1,-3,-4,-4,1
5177,1,-16,-17,1,-17
5178,1,-5,-126,9,-14
5179,1,23,130,13,10
5180,1,4,-45,-5,9
5181,1,-2,-99,9,-11
5182,1,19,84,7,12
5183,1,35,304,19,16
5184,1,5,-66,11,-6
5185,1,-29,204,-12,-17
5186,1,-7,-18,-9,2
5187,1,7,-18,9,-2
5188,1,-12,0,-12,0
5189,1,14,-15,15,-1
5190,1,-4,-117,-13,9
5191,1,-16,63,-7,-9
5192,1,-14,-51,-17,3
5193,1,10,-39,13,-3
5194,1,-7,-78,-13,6
5195,1,3,-18,6,-3
5196,1,22,112,8,14
5197,1,-33,270,-15,-18
5198,1,25,114,6,19
5199,1,-5,-14,2,-7
5200,1,3,0,3,0
5201,1,10,-96,-6,16
5202,1,25,136,17,8
5203,1,4,-45,9,-5
5204,1,-9,-10,-10,1
5205,1,9,-36,12,-3
5206,1,1,-20,5,-4
5207,1,14,13,1,13
5208,1,-23,130,-13,-10
5209,1,27,140,7,20
5210,1,-22,105,-15,-7
5211,1,21,90,15,6
5212,1,12,-64,-4,16
5213,1,-10,-96,6,-16
5214,1,-14,13,-13,-1
5215,1,-2,-288,16,-18
5216,1,-6,0,-6,0
5217,1,-15,-34,-17,2
5218,1,8,12,6,2
5219,1,15,26,13,2
5220,1,-25,126,-7,-18
5221,1,17,0,0,17
5222,1,7,0,0,7
5223,1,5,-104,13,-8
5224,1,18,45,15,3
5225,1,28,187,11,17
5226,1,12,35,7,5
5227,1,29,180,20,9
5228,1,12,-133,-7,19
5229,1,-6,5,-1,-5
5230,1,-5,-150,-15,10
5231,1,-10,-200,-20,10
5232,1,0,-1,1,-1
5233,1,17,-60,20,-3
5234,1,-11,-152,8,-19
5235,1,2,-120,-10,12
5236,1,-8,-9,-9,1
5237,1,-15,56,-8,-7
5238,1,18,0,0,18
5239,1,15,0,0,15
5240,1,2,-15,5,-3
5241,1,5,-234,-13,18
5242,1,-14,40,-10,-4
5243,1,15,-16,-1,16
5244,1,-9,14,-7,-2
5245,1,11,-60,-4,15
5246,1,-31,240,-15,-16
5247,1,-6,-216,12,-18
5248,1,-1,-90,9,-10
5249,1,23,130,10,13
5250,1,12,-64,-4,16
5251,1,1,-72,9,-8
5252,1,-8,-153,9,-17
5253,1,-21,38,-2,-19
5254,1,-4,-320,16,-20
5255,1,-8,-153,9,-17
5256,1,-2,-255,15,-17
5257,1,32,240,12,20
5258,1,10,16,8,2
5259,1,-26,144,-8,-18
5260,1,-17,-38,-19,2
5261,1,0,-16,-4,4
5262,1,-2,-195,-15,13
5263,1,-7,-170,-17,10
5264,1,3,-54,9,-6
5265,1,3,-70,10,-7
5266,1,3,-270,18,-15
5267,1,3,0,3,0
5268,1,-23,90,-5,-18
5269,1,11,10,1,10
5270,1,-3,-54,6,-9
5271,1,1,-342,19,-18
5272,1,-21,110,-10,-11
5273,1,22,72,18,4
5274,1,-13,12,-1,-12
5275,1,27,152,19,8
5276,1,16,15,1,15
5277,1,-3,-10,2,-5
5278,1,-10,-144,-18,8
5279,1,-2,-224,-16,14
5280,1,-13,-68,4,-17
5281,1,-1,-20,-5,4
5282,1,25,150,15,10
5283,1,14,-32,-2,16
5284,1,3,-28,-4,7
5285,1,-19,-20,-20,1
5286,1,-32,247,-19,-13
5287,1,-10,-11,1,-11
5288,1,-15,0,0,-15
5289,1,6,-112,-8,14
5290,1,3,-88,-8,11
5291,1,-33,266,-14,-19
5292,1,10,-96,16,-6
5293,1,7,-144,16,-9
5294,1,-27,182,-13,-14
5295,1,-19,48,-16,-3
5296,1,11,-26,-2,13
5297,1,-21,54,-18,-3
5298,1,1,-132,-11,12
5299,1,2,-143,-11,13
5300,1,7,-78,13,-6
5301,1,-16,63,-7,-9
5302,1,-11,-180,9,-20
5303,1,3,-154,-11,14
5304,1,-24,135,-9,-15
5305,1,21,54,18,3
5306,1,-3,-10,-5,2
5307,1,-4,-192,-16,12
5308,1,3,-54,9,-6
5309,1,8,-153,17,-9
5310,1,32,252,18,14
5311,1,-25,144,-9,-16
5312,1,22,121,11,11
5313,1,13,0,0,13
5314,1,6,-247,19,-13
5315,1,2,-168,14,-12
5316,1,-11,-80,-16,5
5317,1,7,-170,17,-10
5318,1,4,-140,-10,14
5319,1,2,-288,-16,18
5320,1,-5,-66,6,-11
5321,1,-30,209,-11,-19
5322,1,3,-18,-3,6
5323,1,5,0,0,5
5324,1,-7,-78,-13,6
5325,1,-35,300,-15,-20
5326,1,-24,108,-6,-18
5327,1,22,120,10,12
5328,1,-21,38,-19,-2
5329,1,21,104,8,13
5330,1,-5,-204,-17,12
5331,1,23,132,12,11
5332,1,20,96,8,12
5333,1,13,40,5,8
5334,1,-26,160,-16,-10
5335,1,4,-192,16,-12
5336,1,0,-36,6,-6
5337,1,9,-70,-5,14
5338,1,6,-216,18,-12
5339,1,-4,-32,-8,4
5340,1,-22,105,-15,-7
5341,1,-3,-10,2,-5
5342,1,-22,40,-2,-20
5343,1,-10,-200,-20,10
5344,1,-19,90,-9,-10
5345,1,0,-25,5,-5
5346,1,14,0,0,14
5347,1,-14,45,-5,-9
5348,1,27,140,7,20
5349,1,14,-51,-3,17
5350,1,-10,9,-1,-9
5351,1,-2,-15,-5,3
5352,1,17,-60,-3,20
5353,1,-3,-340,-20,17
5354,1,-4,-12,-6,2
5355,1,21,38,19,2
5356,1,26,133,19,7
5357,1,22,96,6,16
5358,1,24,135,15,9
5359,1,9,-220,20,-11
5360,1,-15,0,-15,0
5361,1,13,22,11,2
5362,1,-19,18,-18,-1
5363,1,3,-304,-16,19
5364,1,1,-210,15,-14
5365,1,7,-78,-6,13
5366,1,-10,-96,-16,6
5367,1,-9,-136,-17,8
5368,1,2,-120,-10,12
5369,1,-26,160,-10,-16
5370,1,5,-50,-5,10
5371,1,-9,18,-3,-6
5372,1,-11,-60,4,-15
5373,1,-26,120,-6,-20
5374,1,-8,-153,-17,9
5375,1,1,-240,16,-15
5376,1,-5,-266,14,-19
5377,1,0,-289,17,-17
5378,1,-10,25,-5,-5
5379,1,-24,108,-18,-6
5380,1,-19,34,-2,-17
5381,1,-14,-72,-18,4
5382,1,-13,0,-13,0
5383,1,6,-91,-7,13
5384,1,4,-192,-12,16
5385,1,-20,84,-14,-6
5386,1,14,-51,-3,17
5387,1,5,-176,16,-11
5388,1,-6,-247,-19,13
5389,1,-38,361,-19,-19
5390,1,3,-238,17,-14
5391,1,-13,-48,3,-16
5392,1,-27,182,-13,-14
5393,1,-30,224,-16,-14
5394,1,7,6,1,6
5395,1,-15,56,-7,-8
5396,1,-16,63,-7,-9
5397,1,-8,-128,8,-16
5398,1,6,-280,-14,20
5399,1,-17,-38,2,-19
5400,1,5,-300,20,-15
5401,1,-11,-180,9,-20
5402,1,-5,-66,6,-11
5403,1,-12,-13,-13,1
5404,1,8,-33,11,-3
5405,1,2,-24,6,-4
5406,1,29,208,16,13
5407,1,-23,102,-17,-6
5408,1,-20,64,-4,-16
5409,1,-24,140,-14,-10
5410,1,-11,-180,-20,9
5411,1,19,90,9,10
5412,1,-1,-342,-19,18
5413,1,-9,-136,-17,8
5414,1,-29,208,-16,-13
5415,1,-23,76,-19,-4
5416,1,-1,-20,-5,4
5417,1,-6,8,-4,-2
5418,1,-15,36,-3,-12
5419,1,-9,0,0,-9
5420,1,-20,0,-20,0
5421,1,-2,-323,17,-19
5422,1,31,234,13,18
5423,1,-6,-112,8,-14
5424,1,13,-30,-2,15
5425,1,5,-150,-10,15
5426,1,-14,-51,-17,3
5427,1,4,3,1,3
5428,1,-17,-38,-19,2
5429,1,9,14,7,2
5430,1,-31,234,-13,-18
5431,1,8,16,4,4
5432,1,-33,272,-17,-16
5433,1,27,182,13,14
5434,1,-26,144,-18,-8
5435,1,-17,0,-17,0
5436,1,11,-42,14,-3
5437,1,30,216,18,12
5438,1,15,44,4,11
5439,1,7,12,4,3
5440,1,-22,72,-4,-18
5441,1,8,-65,13,-5
5442,1,8,-20,-2,10
5443,1,29,190,19,10
5444,1,15,56,8,7
5445,1,-8,-105,-15,7
5446,1,-1,-12,3,-4
5447,1,-3,-40,-8,5
5448,1,-30,221,-13,-17
5449,1,-3,-88,8,-11
5450,1,4,-192,-12,16
5451,1,-26,169,-13,-13
5452,1,-5,-266,-19,14
5453,1,-27,152,-19,-8
5454,1,-3,-54,-9,6
5455,1,22,117,9,13
5456,1,21,20,1,20
5457,1,3,-154,-11,14
5458,1,3,-108,12,-9
5459,1,5,-66,11,-6
5460,1,-17,-18,1,-18
5461,1,-3,-28,-7,4
5462,1,-15,0,0,-15
5463,1,20,64,16,4
5464,1,8,-128,16,-8
5465,1,1,-72,9,-8
5466,1,17,0,17,0
5467,1,4,-221,17,-13
5468,1,-3,-180,-15,12
5469,1,-11,-12,-12,1
5470,1,22,120,10,12
5471,1,-5,0,-5,0
5472,1,23,60,3,20
5473,1,2,-63,9,-7
5474,1,3,-54,9,-6
5475,1,13,36,9,4
5476,1,23,112,16,7
5477,1,-20,36,-2,-18
5478,1,29,190,19,10
5479,1,-7,-98,-14,7
5480,1,10,24,4,6
5481,1,-11,30,-5,-6
5482,1,-14,45,-9,-5
5483,1,21,20,20,1
5484,1,8,-105,15,-7
5485,1,-26,160,-10,-16
5486,1,13,12,12,1
5487,1,-22,120,-12,-10
5488,1,-5,-104,8,-13
5489,1,-3,-130,-13,10
5490,1,-25,154,-11,-14
5491,1,-3,-108,-12,9
5492,1,5,-266,19,-14
5493,1,28,180,10,18
5494,1,0,-25,-5,5
5495,1,-34,289,-17,-17
5496,1,-5,-234,13,-18
5497,1,-20,64,-16,-4
5498,1,-1,-210,14,-15
5499,1,-23,90,-5,-18
5500,1,14,45,9,5
5501,1,-4,-140,10,-14
5502,1,-6,-7,1,-7
5503,1,-30,225,-15,-15
5504,1,20,96,8,12
5505,1,-1,-12,3,-4
5506,1,-3,-154,11,-14
5507,1,2,-143,13,-11
5508,1,29,190,19,10
5509,1,4,-96,12,-8
5510,1,0,-169,13,-13
5511,1,-10,-75,5,-15
5512,1,27,152,19,8
5513,1,0,-225,-15,15
5514,1,29,180,20,9
5515,1,7,12,3,4
5516,1,-9,-90,6,-15
5517,1,6,-55,-5,11
5518,1,-32,240,-12,-20
5519,1,30,216,12,18
5520,1,33,260,20,13
5521,1,-3,-108,9,-12
5522,1,-21,108,-12,-9
5523,1,0,-144,-12,12
5524,1,-22,40,-2,-20
5525,1,14,-51,-3,17
5526,1,-34,285,-19,-15
5527,1,10,-171,19,-9
5528,1,-7,-44,-11,4
5529,1,3,-54,9,-6
5530,1,4,-32,-4,8
5531,1,-34,280,-14,-20
5532,1,15,26,13,2
5533,1,-20,51,-17,-3
5534,1,-14,-120,-20,6
5535,1,-2,-48,6,-8
5536,1,8,-9,-1,9
5537,1,1,-210,15,-14
5538,1,-8,7,-7,-1
5539,1,-10,-144,-18,8
5540,1,16,-36,-2,18
5541,1,-13,-90,5,-18
5542,1,-9,-136,-17,8
5543,1,-14,33,-11,-3
5544,1,18,77,11,7
5545,1,9,14,2,7
5546,1,-26,160,-10,-16
5547,1,-18,65,-13,-5
5548,1,0,-400,20,-20
5549,1,-32,252,-14,-18
5550,1,5,-234,18,-13
5551,1,-17,-38,2,-19
5552,1,31,238,17,14
5553,1,-7,0,0,-7
5554,1,17,70,7,10
5555,1,-2,-255,-17,15
5556,1,-11,-42,3,-14
5557,1,-2,-99,9,-11
5558,1,4,-21,-3,7
5559,1,3,-154,14,-11
5560,1,15,0,15,0
5561,1,10,-11,-1,11
5562,1,-4,-252,-18,14
5563,1,39,380,20,19
5564,1,-11,24,-3,-8
5565,1,20,99,11,9
5566,1,-12,32,-4,-8
5567,1,-7,-144,9,-16
5568,1,-21,104,-8,-13
5569,1,8,-33,-3,11
5570,1,-13,42,-7,-6
5571,1,2,-224,16,-14
5572,1,-4,-60,-10,6
5573,1,31,220,20,11
5574,1,-32,256,-16,-16
5575,1,-27,182,-13,-14
5576,1,-11,30,-6,-5
5577,1,16,-80,-4,20
5578,1,-28,196,-14,-14
5579,1,-9,20,-4,-5
5580,1,4,-252,-14,18
5581,1,24,95,5,19
5582,1,-14,-72,-18,4
5583,1,19,88,8,11
5584,1,-7,-78,-13,6
5585,1,29,180,20,9
5586,1,3,-180,15,-12
5587,1,11,28,4,7
5588,1,-29,210,-15,-14
5589,1,-31,220,-20,-11
5590,1,-3,-130,10,-13
5591,1,-14,48,-6,-8
5592,1,25,114,6,19
5593,1,1,0,0,1
5594,1,-1,-132,-12,11
5595,1,21,20,1,20
5596,1,-8,16,-4,-4
5597,1,26,168,14,12
5598,1,11,10,10,1
5599,1,7,12,4,3
5600,1,15,-100,-5,20
5601,1,5,4,1,4
5602,1,-14,49,-7,-7
5603,1,-2,-120,10,-12
5604,1,25,156,13,12
5605,1,16,-17,-1,17
5606,1,-8,-48,4,-12
5607,1,10,-200,20,-10
5608,1,-8,-20,-10,2
5609,1,-29,190,-10,-19
5610,1,-33,266,-14,-19
5611,1,27,180,12,15
5612,1,31,220,20,11
5613,1,3,-304,19,-16
5614,1,-3,-18,-6,3
5615,1,39,380,20,19
5616,1,28,180,18,10
5617,1,0,-9,3,-3
5618,1,-7,-120,-15,8
5619,1,-33,272,-17,-16
5620,1,6,9,3,3
5621,1,7,-170,17,-10
5622,1,2,-48,-6,8
5623,1,8,-128,16,-8
5624,1,3,-238,-14,17
5625,1,-10,-119,7,-17
5626,1,-31,228,-19,-12
5627,1,-7,-78,6,-13
5628,1,24,128,8,16
5629,1,-6,8,-2,-4
5630,1,-2,-15,3,-5
5631,1,0,-1,1,-1
5632,1,2,-288,-16,18
5633,1,9,20,4,5
5634,1,-15,0,-15,0
5635,1,-16,-36,-18,2
5636,1,6,-112,14,-8
5637,1,-7,-8,-8,1
5638,1,-25,154,-14,-11
5639,1,9,14,2,7
5640,1,26,160,10,16
5641,1,-26,160,-16,-10
5642,1,-30,209,-11,-19
5643,1,-18,72,-12,-6
5644,1,25,144,9,16
5645,1,4,-96,-8,12
5646,1,4,-96,-8,12
5647,1,-3,-108,9,-12
5648,1,-6,-135,9,-15
5649,1,-8,-20,2,-10
5650,1,-14,40,-10,-4
5651,1,-13,22,-11,-2
5652,1,-25,136,-8,-17
5653,1,1,-30,-5,6
5654,1,-9,-22,-11,2
5655,1,-8,-240,-20,12
5656,1,-8,-209,11,-19
5657,1,12,0,12,0
5658,1,-35,300,-15,-20
5659,1,7,-18,9,-2
5660,1,-6,-72,-12,6
5661,1,0,-289,-17,17
5662,1,16,48,4,12
5663,1,-24,108,-18,-6
5664,1,0,-49,7,-7
5665,1,0,-324,-18,18
5666,1,-10,21,-7,-3
5667,1,0,-9,3,-3
5668,1,-14,-72,-18,4
5669,1,-37,342,-19,-18
5670,1,-28,187,-17,-11
5671,1,18,56,4,14
5672,1,38,361,19,19
5673,1,-5,-300,15,-20
5674,1,-2,-168,-14,12
5675,1,-20,0,-20,0
5676,1,-4,-45,5,-9
5677,1,-32,252,-14,-18
5678,1,-11,-12,-12,1
5679,1,14,24,12,2
5680,1,-5,-300,-20,15
5681,1,-24,80,-20,-4
5682,1,-19,18,-18,-1
5683,1,7,6,1,6
5684,1,0,-9,-3,3
5685,1,19,84,12,7
5686,1,4,-192,-12,16
5687,1,22,72,18,4
5688,1,-27,152,-19,-8
5689,1,-5,-300,-20,15
5690,1,13,-48,-3,16
5691,1,-22,105,-7,-15
5692,1,13,-48,16,-3
5693,1,3,-28,7,-4
5694,1,5,-150,-10,15
5695,1,6,-91,-7,13
5696,1,-29,208,-13,-16
5697,1,-21,110,-11,-10
5698,1,-11,-180,9,-20
5699,1,39,380,20,19
5700,1,16,39,3,13
5701,1,8,15,5,3
5702,1,6,8,4,2
5703,1,-12,-133,7,-19
5704,1,-17,-18,1,-18
5705,1,-2,-8,2,-4
5706,1,-16,63,-9,-7
5707,1,-2,-15,-5,3
5708,1,-16,64,-8,-8
5709,1,13,-68,17,-4
5710,1,4,-60,10,-6
5711,1,24,144,12,12
5712,1,13,-114,19,-6
5713,1,19,-20,20,-1
5714,1,15,-100,20,-5
5715,1,-2,-80,8,-10
5716,1,-28,160,-20,-8
5717,1,-10,-24,-12,2
5718,1,-6,-27,3,-9
5719,1,2,1,1,1
5720,1,-5,-84,7,-12
5721,1,-21,110,-10,-11
5722,1,6,-55,-5,11
5723,1,-1,-272,-17,16
5724,1,11,-180,20,-9
5725,1,35,306,17,18
5726,1,-21,104,-8,-13
5727,1,26,168,14,12
5728,1,9,-22,-2,11
5729,1,12,35,7,5
5730,1,12,0,0,12
5731,1,27,170,17,10
5732,1,3,-4,-1,4
5733,1,7,-60,-5,12
5734,1,-20,91,-7,-13
5735,1,-15,-54,-18,3
5736,1,-28,180,-18,-10
5737,1,30,216,12,18
5738,1,-34,285,-15,-19
5739,1,2,-195,15,-13
5740,1,37,340,17,20
5741,1,-15,-76,4,-19
5742,1,4,4,2,2
5743,1,-25,150,-15,-10
5744,1,17,72,8,9
5745,1,-5,-14,2,-7
5746,1,-3,-4,-4,1
5747,1,14,-51,17,-3
5748,1,-18,0,-18,0
5749,1,-14,40,-10,-4
5750,1,-19,90,-10,-9
5751,1,27,140,7,20
5752,1,-6,-160,10,-16
5753,1,23,102,6,17
5754,1,18,45,15,3
5755,1,14,45,5,9
5756,1,-16,-17,-17,1
5757,1,3,-88,11,-8
5758,1,-2,-8,2,-4
5759,1,-29,204,-12,-17
5760,1,2,-3,3,-1
5761,1,-6,0,-6,0
5762,1,5,-204,17,-12
5763,1,16,55,5,11
5764,1,-12,-85,5,-17
5765,1,20,75,5,15
5766,1,26,160,16,10
5767,1,-17,60,-5,-12
5768,1,12,20,10,2
5769,1,7,-44,11,-4
5770,1,9,18,6,3
5771,1,4,-12,6,-2
5772,1,10,-56,-4,14
5773,1,-24,135,-9,-15
5774,1,-11,24,-8,-3
5775,1,-1,-272,-17,16
5776,1,-1,-342,-19,18
5777,1,24,119,17,7
5778,1,16,55,11,5
5779,1,-4,-140,10,-14
5780,1,22,105,15,7
5781,1,-10,-171,9,-19
5782,1,-27,170,-10,-17
5783,1,34,285,15,19
5784,1,-29,204,-12,-17
5785,1,12,35,5,7
5786,1,-13,-30,-15,2
5787,1,-10,16,-8,-2
5788,1,-2,-255,15,-17
5789,1,3,-28,7,-4
5790,1,-6,-7,1,-7
5791,1,-6,-160,10,-16
5792,1,-14,48,-8,-6
5793,1,7,-144,16,-9
5794,1,18,0,0,18
5795,1,10,-11,-1,11
5796,1,15,-34,-2,17
5797,1,-15,54,-9,-6
5798,1,-11,0,0,-11
5799,1,23,112,16,7
5800,1,8,0,0,8
5801,1,-2,-99,-11,9
5802,1,29,208,16,13
5803,1,8,-153,17,-9
5804,1,-14,0,-14,0
5805,1,15,50,5,10
5806,1,30,200,20,10
5807,1,-17,70,-10,-7
5808,1,35,300,15,20
5809,1,-16,63,-9,-7
5810,1,-14,-32,-16,2
5811,1,-30,216,-18,-12
5812,1,22,85,5,17
5813,1,36,324,18,18
5814,1,-4,-60,-10,6
5815,1,12,-133,19,-7
5816,1,3,-108,-9,12
5817,1,-9,8,-8,-1
5818,1,13,-48,16,-3
5819,1,-23,60,-3,-20
5820,1,6,-40,-4,10
5821,1,-4,3,-3,-1
5822,1,32,256,16,16
5823,1,-5,-6,-6,1
5824,1,-15,14,-1,-14
5825,1,1,0,0,1
5826,1,25,114,19,6
5827,1,9,-52,13,-4
5828,1,-9,-22,2,-11
5829,1,5,4,1,4
5830,1,24,135,9,15
5831,1,-19,18,-18,-1
5832,1,10,-75,-5,15
5833,1,-20,96,-8,-12
5834,1,13,12,1,12
5835,1,21,90,6,15
5836,1,-22,96,-16,-6
5837,1,-12,-45,-15,3
5838,1,10,-56,14,-4
5839,1,-4,-140,-14,10
5840,1,-12,-28,-14,2
5841,1,-31,240,-16,-15
5842,1,4,-140,-10,14
5843,1,5,-266,-14,19
5844,1,6,-55,11,-5
5845,1,23,60,3,20
5846,1,16,48,4,12
5847,1,-2,0,0,-2
5848,1,-32,255,-15,-17
5849,1,4,0,0,4
5850,1,1,-156,-12,13
5851,1,17,30,2,15
5852,1,-34,289,-17,-17
5853,1,22,57,3,19
5854,1,-7,-144,-16,9
5855,1,-29,198,-18,-11
5856,1,-4,-21,-7,3
5857,1,-22,40,-2,-20
5858,1,6,-187,17,-11
5859,1,-4,-5,1,-5
5860,1,-19,70,-14,-5
5861,1,1,-56,8,-7
5862,1,-30,221,-13,-17
5863,1,16,0,16,0
5864,1,17,72,8,9
5865,1,-23,130,-10,-13
5866,1,15,36,12,3
5867,1,-5,-266,14,-19
5868,1,5,-150,-10,15
5869,1,-13,-30,2,-15
5870,1,-8,7,-7,-1
5871,1,-25,154,-14,-11
5872,1,8,-65,-5,13
5873,1,-10,-96,6,-16
5874,1,29,198,18,11
5875,1,-13,30,-10,-3
5876,1,6,8,4,2
5877,1,12,-133,19,-7
5878,1,-5,-204,-17,12
5879,1,5,4,4,1
5880,1,-13,0,0,-13
5881,1,11,-152,19,-8
5882,1,16,-17,17,-1
5883,1,-13,-140,7,-20
5884,1,22,40,2,20
5885,1,0,-169,-13,13
5886,1,9,-90,-6,15
5887,1,21,20,20,1
5888,1,-34,288,-16,-18
5889,1,20,99,11,9
5890,1,-2,-15,-5,3
5891,1,10,-119,-7,17
5892,1,-13,30,-3,-10
5893,1,-32,255,-15,-17
5894,1,14,-120,20,-6
5895,1,-34,280,-20,-14
5896,1,34,288,18,16
5897,1,-11,-60,4,-15
5898,1,-15,56,-8,-7
5899,1,-4,-60,6,-10
5900,1,3,-18,-3,6
5901,1,18,0,18,0
5902,1,-2,-195,-15,13
5903,1,-25,144,-16,-9
5904,1,-3,-238,-17,14
5905,1,6,5,5,1
5906,1,6,0,6,0
5907,1,-8,-20,2,-10
5908,1,12,-64,16,-4
5909,1,-24,143,-13,-11
5910,1,-5,-300,-20,15
5911,1,-28,171,-9,-19
5912,1,1,-30,-5,6
5913,1,14,0,0,14
5914,1,24,128,16,8
5915,1,-2,-143,-13,11
5916,1,-25,136,-17,-8
5917,1,5,-104,13,-8
5918,1,-25,150,-10,-15
5919,1,20,99,9,11
5920,1,-6,-91,7,-13
5921,1,25,100,20,5
5922,1,0,-64,-8,8
5923,1,17,66,11,6
5924,1,15,56,7,8
5925,1,-16,39,-3,-13
5926,1,31,240,15,16
5927,1,21,104,8,13
5928,1,12,35,5,7
5929,1,16,15,15,1
5930,1,-5,-300,-20,15
5931,1,7,-60,-5,12
5932,1,-33,272,-16,-17
5933,1,1,-12,-3,4
5934,1,16,-57,-3,19
5935,1,12,27,9,3
5936,1,-22,96,-6,-16
5937,1,-11,-80,-16,5
5938,1,25,154,11,14
5939,1,-12,-64,-16,4
5940,1,-8,16,-4,-4
5941,1,-15,-76,4,-19
5942,1,-12,35,-7,-5
5943,1,-3,-70,7,-10
5944,1,-25,114,-19,-6
5945,1,-14,-120,-20,6
5946,1,-31,228,-19,-12
5947,1,-23,120,-15,-8
5948,1,14,24,12,2
5949,1,-16,-80,-20,4
5950,1,29,190,10,19
5951,1,-10,9,-1,-9
5952,1,-16,48,-12,-4
5953,1,-4,3,-1,-3
5954,1,-10,-119,7,-17
5955,1,11,18,2,9
5956,1,4,-192,-12,16
5957,1,-18,45,-15,-3
5958,1,3,-208,-13,16
5959,1,14,33,3,11
5960,1,-5,-104,8,-13
5961,1,-8,-240,12,-20
5962,1,15,44,11,4
5963,1,19,78,13,6
5964,1,-28,187,-11,-17
5965,1,21,68,17,4
5966,1,35,304,19,16
5967,1,-25,126,-7,-18
5968,1,12,-28,-2,14
5969,1,30,209,11,19
5970,1,13,40,8,5
5971,1,-7,-144,-16,9
5972,1,-27,170,-10,-17
5973,1,26,169,13,13
5974,1,-10,-144,-18,8
5975,1,-14,-72,-18,4
5976,1,-22,112,-14,-8
5977,1,2,-323,19,-17
5978,1,-15,50,-5,-10
5979,1,0,-361,-19,19
5980,1,-6,-112,-14,8
5981,1,29,208,16,13
5982,1,-16,0,0,-16
5983,1,10,9,9,1
5984,1,-5,-104,-13,8
5985,1,-31,228,-12,-19
5986,1,18,72,6,12
5987,1,-36,323,-19,-17
5988,1,10,-96,16,-6
5989,1,14,-72,18,-4
5990,1,-5,6,-2,-3
5991,1,-4,0,0,-4
5992,1,-31,220,-11,-20
5993,1,8,-20,-2,10
5994,1,33,272,17,16
5995,1,-23,76,-19,-4
5996,1,3,-54,-6,9
5997,1,16,0,16,0
5998,1,-13,-48,-16,3
5999,1,-22,72,-18,-4
6000,1,11,-180,-9,20
6001,1,8,-180,-10,18
6002,1,0,-49,7,-7
6003,1,8,16,4,4
6004,1,26,160,10,16
6005,1,-36,323,-19,-17
6006,1,-5,-36,4,-9
6007,1,-13,-30,-15,2
6008,1,-18,0,0,-18
6009,1,-27,170,-10,-17
6010,1,-21,110,-10,-11
6011,1,25,136,17,8
6012,1,-12,-133,-19,7
6013,1,28,187,11,17
6014,1,8,-209,-11,19
6015,1,34,280,20,14
6016,1,4,-77,11,-7
6017,1,-16,28,-14,-2
6018,1,-22,96,-6,-16
6019,1,-30,225,-15,-15
6020,1,-10,-39,-13,3
6021,1,-10,-75,-15,5
6022,1,-21,54,-18,-3
6023,1,5,-204,-12,17
6024,1,-12,11,-11,-1
6025,1,2,-224,16,-14
6026,1,20,96,8,12
6027,1,8,-105,15,-7
6028,1,-5,-266,-19,14
6029,1,-19,60,-15,-4
6030,1,38,360,20,18
6031,1,-11,-126,-18,7
6032,1,7,12,4,3
6033,1,-25,114,-19,-6
6034,1,19,70,5,14
6035,1,-15,26,-2,-13
6036,1,25,150,10,15
6037,1,4,0,4,0
6038,1,-2,-15,3,-5
6039,1,-5,4,-1,-4
6040,1,-17,70,-7,-10
6041,1,-27,162,-9,-18
6042,1,-1,0,0,-1
6043,1,31,240,15,16
6044,1,31,228,12,19
6045,1,9,-136,17,-8
6046,1,-22,117,-9,-13
6047,1,18,77,7,11
6048,1,-11,-26,2,-13
6049,1,-13,-140,7,-20
6050,1,11,-12,12,-1
6051,1,15,-76,-4,19
6052,1,13,-30,-2,15
6053,1,-13,-30,-15,2
6054,1,-18,-19,1,-19
6055,1,-28,195,-15,-13
6056,1,3,-130,-10,13
6057,1,-14,45,-9,-5
6058,1,13,22,2,11
6059,1,-28,160,-8,-20
6060,1,-18,32,-2,-16
6061,1,-26,165,-11,-15
6062,1,5,-84,12,-7
6063,1,-3,-70,-10,7
6064,1,-28,192,-12,-16
6065,1,-1,-30,-6,5
6066,1,23,102,6,17
6067,1,23,132,12,11
6068,1,37,340,20,17
6069,1,4,-192,16,-12
6070,1,15,56,7,8
6071,1,8,15,3,5
6072,1,-13,-48,-16,3
6073,1,-13,-90,5,-18
6074,1,-14,-120,-20,6
6075,1,31,234,18,13
6076,1,1,-56,-7,8
6077,1,14,-120,-6,20
6078,1,-12,-160,-20,8
6079,1,14,40,4,10
6080,1,6,-187,17,-11
6081,1,-10,16,-8,-2
6082,1,-23,90,-18,-5
6083,1,-1,-342,18,-19
6084,1,7,12,3,4
6085,1,-8,-33,3,-11
6086,1,-23,120,-8,-15
6087,1,2,-35,7,-5
6088,1,6,-187,-11,17
6089,1,5,-84,12,-7
6090,1,5,-176,16,-11
6091,1,19,90,9,10
6092,1,-16,48,-4,-12
6093,1,33,260,13,20
6094,1,1,-56,8,-7
6095,1,14,-15,-1,15
6096,1,30,209,11,19
6097,1,40,400,20,20
6098,1,-18,81,-9,-9
6099,1,-3,-340,17,-20
6100,1,-21,80,-5,-16
6101,1,-24,140,-14,-10
6102,1,-28,196,-14,-14
6103,1,-21,20,-1,-20
6104,1,-26,144,-8,-18
6105,1,-1,-342,18,-19
6106,1,-1,-210,14,-15
6107,1,4,3,3,1
6108,1,4,-21,-3,7
6109,1,-5,-104,8,-13
6110,1,-4,-320,-20,16
6111,1,7,-30,-3,10
6112,1,-27,180,-15,-12
6113,1,-1,-132,11,-12
6114,1,-20,51,-17,-3
6115,1,12,-85,17,-5
6116,1,-14,45,-9,-5
6117,1,22,120,10,12
6118,1,15,26,2,13
6119,1,-21,20,-20,-1
6120,1,1,-110,11,-10
6121,1,3,-54,9,-6
6122,1,11,28,7,4
6123,1,38,361,19,19
6124,1,-7,12,-4,-3
6125,1,16,48,4,12
6126,1,-5,-150,10,-15
6127,1,21,38,2,19
6128,1,6,-72,12,-6
6129,1,36,320,20,16
6130,1,-2,-8,2,-4
6131,1,1,-272,17,-16
6132,1,-35,306,-18,-17
6133,1,6,0,6,0
6134,1,-11,-152,8,-19
6135,1,-20,91,-7,-13
6136,1,26,160,10,16
6137,1,-10,-144,-18,8
6138,1,-1,-156,12,-13
6139,1,-3,2,-2,-1
6140,1,1,-90,-9,10
6141,1,1,-210,-14,15
6142,1,16,39,13,3
6143,1,4,0,0,4
6144,1,-20,91,-13,-7
6145,1,-1,-240,-16,15
6146,1,-2,-63,7,-9
6147,1,6,-40,10,-4
6148,1,10,16,8,2
6149,1,-6,8,-2,-4
6150,1,9,14,7,2
6151,1,-10,-56,-14,4
6152,1,36,320,20,16
6153,1,-32,240,-12,-20
6154,1,-16,15,-1,-15
6155,1,18,77,7,11
6156,1,20,91,13,7
6157,1,-34,285,-15,-19
6158,1,24,140,10,14
6159,1,-3,-18,3,-6
6160,1,24,108,18,6
6161,1,-28,180,-18,-10
6162,1,23,60,3,20
6163,1,-1,-306,-18,17
6164,1,-6,-112,-14,8
6165,1,0,-16,-4,4
6166,1,8,-240,-12,20
6167,1,11,-42,-3,14
6168,1,2,-63,-7,9
6169,1,-3,-88,-11,8
6170,1,0,-144,12,-12
6171,1,-3,-208,13,-16
6172,1,9,-70,14,-5
6173,1,-24,143,-13,-11
6174,1,10,-24,-2,12
6175,1,17,30,15,2
6176,1,-11,30,-5,-6
6177,1,-7,-30,-10,3
6178,1,-9,14,-7,-2
6179,1,5,4,1,4
6180,1,-10,-39,3,-13
6181,1,24,128,8,16
6182,1,23,132,11,12
6183,1,-15,56,-7,-8
6184,1,-3,-130,10,-13
6185,1,-22,112,-14,-8
6186,1,1,-156,13,-12
6187,1,-10,25,-5,-5
6188,1,22,121,11,11
6189,1,-1,-6,2,-3
6190,1,22,85,17,5
6191,1,24,140,14,10
6192,1,-4,-140,10,-14
6193,1,16,55,11,5
6194,1,-10,9,-9,-1
6195,1,-4,-45,-9,5
6196,1,15,54,9,6
6197,1,22,121,11,11
6198,1,15,54,6,9
6199,1,29,190,19,10
6200,1,-6,8,-4,-2
6201,1,18,80,10,8
6202,1,1,-42,-6,7
6203,1,-6,-160,-16,10
6204,1,-1,-240,-16,15
6205,1,-29,198,-11,-18
6206,1,-14,33,-11,-3
6207,1,-8,0,0,-8
6208,1,0,-9,-3,3
6209,1,12,-45,-3,15
6210,1,23,76,4,19
6211,1,-16,-80,4,-20
6212,1,-1,-56,-8,7
6213,1,-4,-165,-15,11
6214,1,14,49,7,7
6215,1,-2,-35,-7,5
6216,1,17,-38,-2,19
6217,1,-18,45,-15,-3
6218,1,-32,247,-19,-13
6219,1,13,40,5,8
6220,1,-6,-135,9,-15
6221,1,27,140,7,20
6222,1,-27,176,-11,-16
6223,1,-25,100,-20,-5
6224,1,-1,-342,18,-19
6225,1,-8,-20,2,-10
6226,1,-1,-42,-7,6
6227,1,-17,70,-10,-7
6228,1,26,153,17,9
6229,1,-6,-55,5,-11
6230,1,0,0,0,0
6231,1,4,-140,-10,14
6232,1,-8,-33,3,-11
6233,1,14,33,3,11
6234,1,2,-323,-17,19
6235,1,8,-48,-4,12
6236,1,-27,170,-10,-17
6237,1,-10,24,-4,-6
6238,1,-27,182,-14,-13
6239,1,-7,12,-3,-4
6240,1,4,-12,-2,6
6241,1,-25,126,-7,-18
6242,1,15,54,9,6
6243,1,0,-16,-4,4
6244,1,8,-65,13,-5
6245,1,-20,19,-1,-19
6246,1,4,-32,-4,8
6247,1,4,-165,15,-11
6248,1,27,162,9,18
6249,1,28,180,18,10
6250,1,12,-108,18,-6
6251,1,19,18,18,1
6252,1,13,-140,-7,20
6253,1,12,20,10,2
6254,1,2,-360,20,-18
6255,1,18,65,5,13
6256,1,32,255,17,15
6257,1,-23,76,-19,-4
6258,1,-13,36,-9,-4
6259,1,20,64,16,4
6260,1,21,20,1,20
6261,1,22,121,11,11
6262,1,1,-272,-16,17
6263,1,7,-170,-10,17
6264,1,-8,-153,-17,9
6265,1,-12,-28,-14,2
6266,1,5,-24,-3,8
6267,1,-7,-60,-12,5
6268,1,13,-114,-6,19
6269,1,17,-38,-2,19
6270,1,25,156,12,13
6271,1,-12,-160,8,-20
6272,1,15,36,3,12
6273,1,-24,80,-20,-4
6274,1,-35,306,-18,-17
6275,1,3,-130,-10,13
6276,1,-8,-240,12,-20
6277,1,-4,-117,9,-13
6278,1,14,13,13,1
6279,1,4,-221,-13,17
6280,1,-21,104,-13,-8
6281,1,2,-323,19,-17
6282,1,-6,-27,3,-9
6283,1,9,-112,16,-7
6284,1,-25,126,-7,-18
6285,1,-14,45,-5,-9
6286,1,27,170,17,10
6287,1,11,-26,13,-2
6288,1,17,16,1,16
6289,1,17,0,0,17
6290,1,-3,-340,-20,17
6291,1,-10,21,-3,-7
6292,1,-22,72,-18,-4
6293,1,-1,-30,5,-6
6294,1,-28,160,-8,-20
6295,1,21,104,8,13
6296,1,13,-90,-5,18
6297,1,14,-95,19,-5
6298,1,-20,36,-2,-18
6299,1,3,-238,17,-14
6300,1,-5,-14,-7,2
6301,1,-4,0,-4,0
6302,1,-6,-216,12,-18
6303,1,-1,-210,-15,14
6304,1,-31,238,-14,-17
6305,1,-34,288,-18,-16
6306,1,-14,24,-12,-2
6307,1,-7,6,-6,-1
6308,1,17,52,13,4
6309,1,-5,-126,-14,9
6310,1,-10,-75,5,-15
6311,1,-20,64,-4,-16
6312,1,-14,-15,-15,1
6313,1,-1,-342,18,-19
6314,1,14,0,14,0
6315,1,-4,-320,-20,16
6316,1,6,-27,9,-3
6317,1,-27,152,-8,-19
6318,1,31,240,16,15
6319,1,-5,-176,11,-16
6320,1,-6,-187,11,-17
6321,1,2,-3,-1,3
6322,1,29,204,12,17
6323,1,-10,-96,6,-16
6324,1,0,-324,18,-18
6325,1,-16,-57,3,-19
6326,1,11,0,0,11
6327,1,-10,-119,-17,7
6328,1,-16,-17,1,-17
6329,1,-6,-247,-19,13
6330,1,5,-150,-10,15
6331,1,24,140,10,14
6332,1,-5,-14,2,-7
6333,1,-23,76,-4,-19
6334,1,14,45,5,9
6335,1,-15,50,-10,-5
6336,1,-20,36,-2,-18
6337,1,2,-63,9,-7
6338,1,-34,288,-16,-18
6339,1,0,-169,13,-13
6340,1,5,6,2,3
6341,1,-8,-33,-11,3
6342,1,32,255,15,17
6343,1,24,95,19,5
6344,1,1,-42,-6,7
6345,1,-8,-20,-10,2
6346,1,-1,-2,1,-2
6347,1,32,247,13,19
6348,1,-22,112,-8,-14
6349,1,-19,34,-17,-2
6350,1,-9,-52,4,-13
6351,1,30,221,13,17
6352,1,-1,-2,-2,1
6353,1,-1,-12,3,-4
6354,1,-4,-32,4,-8
6355,1,16,64,8,8
6356,1,-21,104,-13,-8
6357,1,6,-216,18,-12
6358,1,3,-270,18,-15
6359,1,26,153,17,9
6360,1,-12,27,-3,-9
6361,1,27,162,18,9
6362,1,-30,200,-20,-10
6363,1,25,154,14,11
6364,1,-15,14,-14,-1
6365,1,-12,27,-3,-9
6366,1,1,-30,6,-5
6367,1,20,84,6,14
6368,1,30,224,16,14
6369,1,18,-40,20,-2
6370,1,-19,18,-1,-18
6371,1,30,209,19,11
6372,1,-23,126,-14,-9
6373,1,4,-320,20,-16
6374,1,10,9,9,1
6375,1,30,224,16,14
6376,1,21,20,1,20
6377,1,27,162,9,18
6378,1,2,-15,5,-3
6379,1,-10,-39,-13,3
6380,1,29,208,13,16
6381,1,-8,-9,-9,1
6382,1,-5,-300,15,-20
6383,1,-1,-72,-9,8
6384,1,-5,-234,-18,13
6385,1,-16,-57,3,-19
6386,1,17,66,6,11
6387,1,-10,24,-6,-4
6388,1,-6,8,-2,-4
6389,1,10,-11,-1,11
6390,1,10,9,9,1
6391,1,-5,-126,9,-14
6392,1,13,-30,-2,15
6393,1,33,260,20,13
6394,1,10,-119,17,-7
6395,1,31,220,11,20
6396,1,1,-110,11,-10
6397,1,-12,-28,2,-14
6398,1,-15,-100,-20,5
6399,1,-14,0,0,-14
6400,1,-8,-65,5,-13
6401,1,-21,108,-12,-9
6402,1,10,-75,15,-5
6403,1,22,112,14,8
6404,1,2,-99,11,-9
6405,1,28,196,14,14
6406,1,-19,78,-6,-13
6407,1,-23,112,-7,-16
6408,1,4,-5,-1,5
6409,1,-14,-95,-19,5
6410,1,0,-64,8,-8
6411,1,-1,-20,-5,4
6412,1,22,72,4,18
6413,1,-17,52,-4,-13
6414,1,9,0,0,9
6415,1,15,-100,-5,20
6416,1,-9,-36,3,-12
6417,1,-19,18,-1,-18
6418,1,22,105,15,7
6419,1,10,-56,-4,14
6420,1,8,-65,-5,13
6421,1,-20,99,-11,-9
6422,1,-2,-15,-5,3
6423,1,37,342,19,18
6424,1,3,-108,12,-9
6425,1,18,65,13,5
6426,1,8,7,7,1
6427,1,-3,-88,-11,8
6428,1,1,-110,-10,11
6429,1,-11,30,-6,-5
6430,1,16,-17,17,-1
6431,1,24,144,12,12
6432,1,-17,-18,-18,1
6433,1,-9,-190,-19,10
6434,1,-5,-150,-15,10
6435,1,-5,0,0,-5
6436,1,-17,72,-8,-9
6437,1,-33,266,-19,-14
6438,1,34,288,16,18
6439,1,15,26,13,2
6440,1,14,-95,19,-5
6441,1,3,0,0,3
6442,1,-10,-56,4,-14
6443,1,22,40,20,2
6444,1,-28,180,-10,-18
6445,1,24,144,12,12
6446,1,3,-10,5,-2
6447,1,7,-60,12,-5
6448,1,18,45,15,3
6449,1,23,130,10,13
6450,1,1,-30,-5,6
6451,1,-4,-5,-5,1
6452,1,33,270,18,15
6453,1,12,0,12,0
6454,1,-22,120,-10,-12
6455,1,0,-324,18,-18
6456,1,-14,-15,-15,1
6457,1,-3,-130,10,-13
6458,1,-17,70,-7,-10
6459,1,18,32,16,2
6460,1,-23,60,-20,-3
6461,1,-16,60,-6,-10
6462,1,0,-49,7,-7
6463,1,-5,-24,3,-8
6464,1,-13,42,-7,-6
6465,1,-4,-165,-15,11
6466,1,15,54,9,6
6467,1,-18,-19,1,-19
6468,1,-16,0,-16,0
6469,1,4,-285,19,-15
6470,1,9,-112,-7,16
6471,1,-23,130,-13,-10
6472,1,-37,340,-20,-17
6473,1,-11,-80,5,-16
6474,1,-14,-15,1,-15
6475,1,-14,-51,3,-17
6476,1,-4,-320,-20,16
6477,1,-4,-32,4,-8
6478,1,-16,55,-11,-5
6479,1,0,-225,-15,15
6480,1,-13,0,-13,0
6481,1,8,7,1,7
6482,1,-30,200,-10,-20
6483,1,19,34,2,17
6484,1,37,342,19,18
6485,1,-7,-170,10,-17
6486,1,26,160,10,16
6487,1,3,-154,14,-11
6488,1,23,112,16,7
6489,1,-13,-48,3,-16
6490,1,-9,-220,11,-20
6491,1,30,209,11,19
6492,1,-3,0,-3,0
6493,1,-27,180,-15,-12
6494,1,-8,-209,-19,11
6495,1,30,225,15,15
6496,1,-6,-27,-9,3
6497,1,4,-192,-12,16
6498,1,29,204,12,17
6499,1,25,150,15,10
6500,1,-7,6,-6,-1
6501,1,17,72,9,8
6502,1,16,60,10,6
6503,1,-9,-52,4,-13
6504,1,-15,-76,4,-19
6505,1,-24,135,-15,-9
6506,1,10,9,1,9
6507,1,-8,-128,8,-16
6508,1,3,0,0,3
6509,1,-24,140,-14,-10
6510,1,18,81,9,9
6511,1,-29,180,-20,-9
6512,1,9,-136,17,-8
6513,1,-21,80,-16,-5
6514,1,14,24,12,2
6515,1,-2,-323,-19,17
6516,1,-7,-8,1,-8
6517,1,-22,96,-6,-16
6518,1,8,12,2,6
6519,1,-2,-143,-13,11
6520,1,6,-72,-6,12
6521,1,25,126,7,18
6522,1,14,-95,-5,19
6523,1,5,-266,-14,19
6524,1,26,165,15,11
6525,1,7,-18,-2,9
6526,1,-4,-192,-16,12
6527,1,8,16,4,4
6528,1,-23,90,-5,-18
6529,1,18,77,7,11
6530,1,12,27,9,3
6531,1,27,140,20,7
6532,1,15,14,14,1
6533,1,-20,64,-4,-16
6534,1,-4,0,-4,0
6535,1,16,28,2,14
6536,1,14,-120,-6,20
6537,1,29,190,10,19
6538,1,7,-260,-13,20
6539,1,15,54,9,6
6540,1,-24,80,-20,-4
6541,1,-24,143,-13,-11
6542,1,4,-165,-11,15
6543,1,9,-36,-3,12
6544,1,20,100,10,10
6545,1,-9,14,-2,-7
6546,1,5,-84,-7,12
6547,1,0,-49,7,-7
6548,1,-30,224,-16,-14
6549,1,19,-20,-1,20
6550,1,-1,-210,-15,14
6551,1,-5,-84,-12,7
6552,1,-2,-120,10,-12
6553,1,8,-128,16,-8
6554,1,-22,117,-13,-9
6555,1,-2,-288,-18,16
6556,1,-34,285,-19,-15
6557,1,-17,66,-11,-6
6558,1,-2,-195,-15,13
6559,1,-7,10,-5,-2
6560,1,-9,-36,-12,3
6561,1,15,-76,19,-4
6562,1,-1,-132,-12,11
6563,1,-2,-48,-8,6
6564,1,16,-36,18,-2
6565,1,1,0,1,0
6566,1,-1,-72,8,-9
6567,1,8,-65,-5,13
6568,1,-12,0,0,-12
6569,1,32,240,12,20
6570,1,-17,-60,3,-20
6571,1,-15,-76,-19,4
6572,1,-4,-192,-16,12
6573,1,22,105,7,15
6574,1,-14,-32,-16,2
6575,1,29,208,13,16
6576,1,-4,-5,-5,1
6577,1,-23,130,-10,-13
6578,1,11,-60,-4,15
6579,1,3,-28,-4,7
6580,1,-23,130,-13,-10
6581,1,1,-42,-6,7
6582,1,23,90,5,18
6583,1,-1,-72,8,-9
6584,1,4,-77,11,-7
6585,1,20,84,6,14
6586,1,-8,16,-4,-4
6587,1,-14,13,-13,-1
6588,1,-5,-14,2,-7
6589,1,-31,240,-15,-16
6590,1,-2,-24,4,-6
6591,1,-39,380,-19,-20
6592,1,14,-15,-1,15
6593,1,-3,-28,-7,4
6594,1,-8,-180,-18,10
6595,1,0,-81,-9,9
6596,1,-6,-135,-15,9
6597,1,-28,195,-15,-13
6598,1,11,24,8,3
6599,1,18,45,3,15
6600,1,25,114,19,6
6601,1,-30,200,-20,-10
6602,1,-16,15,-15,-1
6603,1,21,110,11,10
6604,1,-10,-200,-20,10
6605,1,-19,78,-6,-13
6606,1,2,-48,-6,8
6607,1,12,35,5,7
6608,1,28,187,17,11
6609,1,-2,-195,-15,13
6610,1,-9,14,-7,-2
6611,1,-11,28,-4,-7
6612,1,-22,96,-6,-16
6613,1,-32,256,-16,-16
6614,1,12,-133,-7,19
6615,1,-35,306,-18,-17
6616,1,-6,-40,-10,4
6617,1,-31,234,-18,-13
6618,1,1,-342,-18,19
6619,1,-1,-110,-11,10
6620,1,-21,38,-2,-19
6621,1,32,252,14,18
6622,1,8,15,5,3
6623,1,1,-20,-4,5
6624,1,-1,-110,10,-11
6625,1,-31,238,-17,-14
6626,1,28,180,10,18
6627,1,17,70,10,7
6628,1,-5,-24,3,-8
6629,1,24,135,9,15
6630,1,18,80,10,8
6631,1,-21,68,-4,-17
6632,1,16,39,3,13
6633,1,12,20,2,10
6634,1,-7,-78,6,-13
6635,1,1,-6,-2,3
6636,1,13,22,11,2
6637,1,-5,-176,-16,11
6638,1,30,221,13,17
6639,1,-20,75,-5,-15
6640,1,-12,20,-2,-10
6641,1,-20,0,-20,0
6642,1,-8,12,-6,-2
6643,1,2,-168,-12,14
6644,1,8,-65,13,-5
6645,1,-6,-40,4,-10
6646,1,-28,171,-9,-19
6647,1,26,169,13,13
6648,1,-8,-209,-19,11
6649,1,7,0,0,7
6650,1,-5,-176,11,-16
6651,1,-19,-20,-20,1
6652,1,9,0,0,9
6653,1,32,252,14,18
6654,1,-6,-280,14,-20
6655,1,-27,180,-15,-12
6656,1,15,26,2,13
6657,1,-8,-65,5,-13
6658,1,-18,17,-17,-1
6659,1,10,-11,11,-1
6660,1,-14,48,-8,-6
6661,1,-1,-110,-11,10
6662,1,-7,-8,-8,1
6663,1,11,-26,-2,13
6664,1,0,-100,-10,10
6665,1,-8,-153,9,-17
6666,1,29,204,17,12
6667,1,0,-64,8,-8
6668,1,2,-323,19,-17
6669,1,0,-196,14,-14
6670,1,12,-133,-7,19
6671,1,11,-26,13,-2
6672,1,-2,-195,13,-15
6673,1,18,45,3,15
6674,1,3,-54,9,-6
6675,1,18,17,17,1
6676,1,3,-4,-1,4
6677,1,22,85,17,5
6678,1,-28,195,-13,-15
6679,1,-11,-26,-13,2
6680,1,14,33,3,11
6681,1,6,-160,16,-10
6682,1,5,4,1,4
6683,1,-24,144,-12,-12
6684,1,3,-28,7,-4
6685,1,2,-24,6,-4
6686,1,-9,8,-1,-8
6687,1,-6,-112,-14,8
6688,1,-16,0,-16,0
6689,1,1,-110,-10,11
6690,1,12,32,8,4
6691,1,-15,50,-5,-10
6692,1,12,0,0,12
6693,1,12,-160,20,-8
6694,1,-17,-18,-18,1
6695,1,-11,-42,-14,3
6696,1,-25,150,-10,-15
6697,1,14,-120,-6,20
6698,1,-9,-90,6,-15
6699,1,24,135,15,9
6700,1,30,216,18,12
6701,1,-7,-30,3,-10
6702,1,15,26,13,2
6703,1,-12,-108,-18,6
6704,1,-13,42,-6,-7
6705,1,8,-84,-6,14
6706,1,-18,-19,-19,1
6707,1,-6,-27,3,-9
6708,1,15,-16,-1,16
6709,1,-25,154,-11,-14
6710,1,-6,8,-2,-4
6711,1,18,17,1,17
6712,1,-7,6,-1,-6
6713,1,28,195,15,13
6714,1,22,72,4,18
6715,1,31,234,18,13
6716,1,-35,300,-15,-20
6717,1,-11,-180,-20,9
6718,1,14,-120,20,-6
6719,1,0,-400,20,-20
6720,1,8,-9,-1,9
6721,1,0,-256,16,-16
6722,1,-1,-342,18,-19
6723,1,-25,100,-5,-20
6724,1,-7,-44,-11,4
6725,1,-24,128,-16,-8
6726,1,-2,0,0,-2
6727,1,17,52,4,13
6728,1,23,102,6,17
6729,1,-13,42,-7,-6
6730,1,-28,160,-20,-8
6731,1,-1,-272,16,-17
6732,1,8,-105,-7,15
6733,1,2,-3,3,-1
6734,1,16,28,2,14
6735,1,1,-30,6,-5
6736,1,17,72,9,8
6737,1,-15,54,-6,-9
6738,1,-29,210,-15,-14
6739,1,35,304,19,16
6740,1,-15,-76,-19,4
6741,1,-15,-54,3,-18
6742,1,2,-35,-5,7
6743,1,-11,-152,-19,8
6744,1,5,6,2,3
6745,1,3,2,2,1
6746,1,-8,0,0,-8
6747,1,8,-65,13,-5
6748,1,-17,66,-6,-11
6749,1,21,108,9,12
6750,1,8,-48,12,-4
6751,1,17,30,2,15
6752,1,-25,136,-17,-8
6753,1,-12,-160,8,-20
6754,1,-40,400,-20,-20
6755,1,-11,-80,5,-16
6756,1,8,-20,10,-2
6757,1,-16,15,-1,-15
6758,1,8,15,3,5
6759,1,-14,49,-7,-7
6760,1,38,360,18,20
6761,1,-1,-156,12,-13
6762,1,-23,130,-10,-13
6763,1,11,-80,-5,16
6764,1,-1,0,0,-1
6765,1,20,19,19,1
6766,1,5,-84,-7,12
6767,1,18,-40,-2,20
6768,1,-26,133,-19,-7
6769,1,-13,-48,3,-16
6770,1,-6,-27,-9,3
6771,1,16,-80,20,-4
6772,1,21,20,1,20
6773,1,6,-27,-3,9
6774,1,6,-247,-13,19
6775,1,19,70,14,5
6776,1,12,32,4,8
6777,1,-13,12,-12,-1
6778,1,27,170,17,10
6779,1,3,-130,-10,13
6780,1,-20,100,-10,-10
6781,1,-1,-2,-2,1
6782,1,4,-192,-12,16
6783,1,-31,238,-14,-17
6784,1,-4,-117,9,-13
6785,1,-9,8,-1,-8
6786,1,-2,-8,2,-4
6787,1,12,35,7,5
6788,1,-16,48,-12,-4
6789,1,20,100,10,10
6790,1,-16,64,-8,-8
6791,1,-17,52,-4,-13
6792,1,9,-190,-10,19
6793,1,16,0,0,16
6794,1,10,-39,-3,13
6795,1,-14,-51,-17,3
6796,1,15,54,9,6
6797,1,-14,33,-3,-11
6798,1,28,180,10,18
6799,1,4,4,2,2
6800,1,-17,30,-15,-2
6801,1,-15,50,-5,-10
6802,1,11,-60,15,-4
6803,1,5,-84,12,-7
6804,1,-12,11,-1,-11
6805,1,33,260,13,20
6806,1,3,-70,10,-7
6807,1,-16,28,-2,-14
6808,1,10,24,6,4
6809,1,-16,39,-3,-13
6810,1,8,-153,-9,17
6811,1,-33,270,-18,-15
6812,1,7,-228,19,-12
6813,1,3,-130,-10,13
6814,1,7,-228,-12,19
6815,1,34,288,18,16
6816,1,8,15,5,3
6817,1,8,-48,12,-4
6818,1,3,-18,-3,6
6819,1,-1,-380,19,-20
6820,1,-23,112,-16,-7
6821,1,22,72,4,18
6822,1,24,128,16,8
6823,1,-7,-8,-8,1
6824,1,11,-60,15,-4
6825,1,-5,-24,3,-8
6826,1,19,-20,20,-1
6827,1,-11,30,-5,-6
6828,1,-11,28,-4,-7
6829,1,20,36,18,2
6830,1,-12,11,-11,-1
6831,1,19,0,19,0
6832,1,15,-100,-5,20
6833,1,7,-170,-10,17
6834,1,-30,225,-15,-15
6835,1,-7,-98,-14,7
6836,1,-4,3,-3,-1
6837,1,-26,153,-17,-9
6838,1,-3,0,-3,0
6839,1,-6,0,-6,0
6840,1,-18,72,-6,-12
6841,1,13,-114,-6,19
6842,1,21,54,18,3
6843,1,-2,-15,-5,3
6844,1,-19,0,0,-19
6845,1,3,-18,-3,6
6846,1,6,8,4,2
6847,1,-28,171,-19,-9
6848,1,-4,-221,-17,13
6849,1,15,44,4,11
6850,1,-8,-240,12,-20
6851,1,-25,150,-15,-10
6852,1,-10,-171,9,-19
6853,1,-10,-39,-13,3
6854,1,-21,68,-4,-17
6855,1,11,-80,-5,16
6856,1,14,-51,-3,17
6857,1,3,-130,-10,13
6858,1,-14,-95,5,-19
6859,1,-30,216,-12,-18
6860,1,-17,30,-15,-2
6861,1,17,42,3,14
6862,1,-2,-168,12,-14
6863,1,16,-17,-1,17
6864,1,-1,-2,-2,1
6865,1,-30,216,-12,-18
6866,1,12,36,6,6
6867,1,-6,-112,-14,8
6868,1,18,32,2,16
6869,1,10,-75,15,-5
6870,1,11,0,11,0
6871,1,29,190,19,10
6872,1,-13,30,-10,-3
6873,1,-6,-7,1,-7
6874,1,14,-15,-1,15
6875,1,-7,-78,6,-13
6876,1,-20,19,-1,-19
6877,1,18,-40,-2,20
6878,1,37,342,19,18
6879,1,1,-20,5,-4
6880,1,14,-120,20,-6
6881,1,-8,12,-2,-6
6882,1,29,190,19,10
6883,1,-12,27,-9,-3
6884,1,-8,15,-3,-5
6885,1,12,27,9,3
6886,1,1,-90,10,-9
6887,1,6,-55,-5,11
6888,1,29,180,20,9
6889,1,-4,-12,-6,2
6890,1,-13,-30,-15,2
6891,1,19,-20,20,-1
6892,1,12,11,11,1
6893,1,17,16,16,1
6894,1,2,-15,-3,5
6895,1,-38,361,-19,-19
6896,1,-34,280,-14,-20
6897,1,-7,-30,3,-10
6898,1,-4,-96,8,-12
6899,1,37,342,18,19
6900,1,0,-144,-12,12
6901,1,-7,6,-1,-6
6902,1,35,300,15,20
6903,1,-19,34,-2,-17
6904,1,2,-80,-8,10
6905,1,1,-56,-7,8
6906,1,-4,-221,13,-17
6907,1,-8,-9,-9,1
6908,1,-6,-91,7,-13
6909,1,-20,51,-3,-17
6910,1,3,-4,4,-1
6911,1,11,-126,18,-7
6912,1,31,238,14,17
6913,1,2,-323,19,-17
6914,1,20,91,7,13
6915,1,18,77,11,7
6916,1,15,36,12,3
6917,1,23,90,18,5
6918,1,30,209,11,19
6919,1,-20,91,-13,-7
6920,1,4,4,2,2
6921,1,-1,-42,6,-7
6922,1,9,18,3,6
6923,1,33,260,13,20
6924,1,21,110,10,11
6925,1,-19,78,-13,-6
6926,1,-6,8,-4,-2
6927,1,-28,196,-14,-14
6928,1,-18,65,-13,-5
6929,1,-20,64,-16,-4
6930,1,11,-126,-7,18
6931,1,7,-18,9,-2
6932,1,26,153,17,9
6933,1,15,-76,19,-4
6934,1,16,-36,18,-2
6935,1,9,8,8,1
6936,1,-3,-304,16,-19
6937,1,-17,0,-17,0
6938,1,28,171,19,9
6939,1,19,84,12,7
6940,1,-20,75,-15,-5
6941,1,-1,-20,-5,4
6942,1,-5,-14,2,-7
6943,1,21,110,10,11
6944,1,25,126,7,18
6945,1,17,0,17,0
6946,1,18,32,16,2
6947,1,15,0,15,0
6948,1,15,0,0,15
6949,1,9,-90,15,-6
6950,1,-5,-126,-14,9
6951,1,1,-380,20,-19
6952,1,10,-39,13,-3
6953,1,10,-200,20,-10
6954,1,3,-10,5,-2
6955,1,12,36,6,6
6956,1,2,-288,18,-16
6957,1,36,320,20,16
6958,1,-6,-216,12,-18
6959,1,-15,36,-3,-12
6960,1,4,-32,8,-4
6961,1,14,45,9,5
6962,1,25,156,12,13
6963,1,5,-14,7,-2
6964,1,-22,57,-19,-3
6965,1,-3,-304,16,-19
6966,1,13,12,1,12
6967,1,-13,12,-1,-12
6968,1,2,-24,6,-4
6969,1,-26,133,-19,-7
6970,1,0,-324,-18,18
6971,1,-6,-135,9,-15
6972,1,-25,114,-6,-19
6973,1,-7,-98,-14,7
6974,1,9,-112,-7,16
6975,1,-12,-13,-13,1
6976,1,7,-198,18,-11
6977,1,20,96,8,12
6978,1,-3,-88,-11,8
6979,1,-10,-171,9,-19
6980,1,-13,-140,7,-20
6981,1,7,0,0,7
6982,1,5,-126,14,-9
6983,1,-3,0,0,-3
6984,1,-15,-34,-17,2
6985,1,3,-18,6,-3
6986,1,29,208,16,13
6987,1,-3,-18,3,-6
6988,1,-21,108,-9,-12
6989,1,0,-289,17,-17
6990,1,10,-56,-4,14
6991,1,2,0,0,2
6992,1,-33,266,-14,-19
6993,1,19,-20,-1,20
6994,1,7,10,2,5
6995,1,29,198,18,11
6996,1,-6,-27,-9,3
6997,1,-19,88,-11,-8
6998,1,4,-32,8,-4
6999,1,-8,-180,10,-18
7000,1,34,288,18,16
7001,1,25,150,15,10
7002,1,-1,-12,-4,3
7003,1,-23,112,-16,-7
7004,1,-18,45,-15,-3
7005,1,11,-126,18,-7
7006,1,-3,-4,-4,1
7007,1,-31,234,-18,-13
7008,1,-2,-99,9,-11
7009,1,-8,-33,-11,3
7010,1,-2,-360,18,-20
7011,1,4,-192,16,-12
7012,1,-25,156,-13,-12
7013,1,-14,0,-14,0
7014,1,9,0,0,9
7015,1,-22,85,-17,-5
7016,1,24,143,13,11
7017,1,-36,324,-18,-18
7018,1,-5,6,-3,-2
7019,1,-12,36,-6,-6
7020,1,7,-44,11,-4
7021,1,17,0,0,17
7022,1,-15,14,-1,-14
7023,1,-12,27,-3,-9
7024,1,-22,96,-16,-6
7025,1,-10,-11,1,-11
7026,1,6,-160,-10,16
7027,1,17,42,14,3
7028,1,-18,17,-17,-1
7029,1,-2,-224,-16,14
7030,1,-16,-57,3,-19
7031,1,6,8,2,4
7032,1,26,169,13,13
7033,1,-10,-119,-17,7
7034,1,-25,114,-6,-19
7035,1,-7,-78,-13,6
7036,1,18,81,9,9
7037,1,27,180,12,15
7038,1,-11,-152,8,-19
7039,1,-29,198,-18,-11
7040,1,-13,-48,-16,3
7041,1,-10,21,-3,-7
7042,1,21,110,10,11
7043,1,-8,-209,-19,11
7044,1,0,-36,6,-6
7045,1,4,-140,14,-10
7046,1,21,108,12,9
7047,1,14,24,12,2
7048,1,4,4,2,2
7049,1,29,198,11,18
7050,1,5,-84,-7,12
7051,1,-14,0,-14,0
7052,1,5,-204,17,-12
7053,1,-7,-198,11,-18
7054,1,-28,160,-8,-20
7055,1,-15,44,-4,-11
7056,1,1,-156,-12,13
7057,1,9,-36,12,-3
7058,1,11,30,6,5
7059,1,-20,51,-3,-17
7060,1,-1,-20,-5,4
7061,1,-25,156,-13,-12
7062,1,11,-60,15,-4
7063,1,-31,228,-12,-19
7064,1,-28,180,-10,-18
7065,1,-28,187,-17,-11
7066,1,5,-14,7,-2
7067,1,-11,-180,-20,9
7068,1,25,150,15,10
7069,1,1,-182,-13,14
7070,1,-19,48,-3,-16
7071,1,-19,88,-11,-8
7072,1,-2,-360,-20,18
7073,1,-36,320,-20,-16
7074,1,-13,-114,6,-19
7075,1,13,12,12,1
7076,1,-20,91,-13,-7
7077,1,-12,36,-6,-6
7078,1,1,-6,3,-2
7079,1,-14,-120,6,-20
7080,1,14,-120,20,-6
7081,1,16,55,5,11
7082,1,-17,66,-11,-6
7083,1,5,-6,-1,6
7084,1,-6,8,-2,-4
7085,1,2,-8,4,-2
7086,1,-13,0,-13,0
7087,1,7,-170,17,-10
7088,1,12,-160,20,-8
7089,1,-12,-85,-17,5
7090,1,-1,-240,15,-16
7091,1,32,240,20,12
7092,1,17,60,12,5
7093,1,17,52,4,13
7094,1,-12,-133,-19,7
7095,1,-7,-98,7,-14
7096,1,18,-40,-2,20
7097,1,-13,22,-2,-11
7098,1,15,50,10,5
7099,1,1,-380,20,-19
7100,1,-2,-120,10,-12
7101,1,15,-16,-1,16
7102,1,9,-220,-11,20
7103,1,-5,6,-2,-3
7104,1,-18,80,-8,-10
7105,1,4,-45,9,-5
7106,1,-5,-126,-14,9
7107,1,7,-30,-3,10
7108,1,23,102,6,17
7109,1,-11,-12,1,-12
7110,1,-18,-40,2,-20
7111,1,-16,-36,-18,2
7112,1,10,16,2,8
7113,1,-3,-130,10,-13
7114,1,-12,-13,1,-13
7115,1,-17,-60,-20,3
7116,1,28,171,9,19
7117,1,-1,-42,6,-7
7118,1,17,72,8,9
7119,1,8,-209,-11,19
7120,1,-19,0,-19,0
7121,1,0,0,0,0
7122,1,1,-20,5,-4
7123,1,7,-18,9,-2
7124,1,1,-156,-12,13
7125,1,-7,-44,-11,4
7126,1,-14,-15,1,-15
7127,1,8,-20,-2,10
7128,1,-7,-30,3,-10
7129,1,10,-11,-1,11
7130,1,-12,-64,-16,4
7131,1,-30,224,-14,-16
7132,1,-11,-102,-17,6
7133,1,-9,-220,11,-20
7134,1,8,-180,18,-10
7135,1,-13,-14,1,-14
7136,1,-18,32,-16,-2
7137,1,-25,156,-12,-13
7138,1,32,247,19,13
7139,1,2,-24,-4,6
7140,1,21,104,8,13
7141,1,13,-14,14,-1
7142,1,-9,-220,-20,11
7143,1,-2,-63,-9,7
7144,1,-25,114,-19,-6
7145,1,21,20,20,1
7146,1,-23,130,-10,-13
7147,1,29,204,17,12
7148,1,-9,-10,1,-10
7149,1,22,57,19,3
7150,1,-31,228,-19,-12
7151,1,23,130,13,10
7152,1,2,-3,-1,3
7153,1,-23,90,-5,-18
7154,1,-10,16,-8,-2
7155,1,-2,-323,-19,17
7156,1,-14,-15,1,-15
7157,1,10,21,3,7
7158,1,-16,0,-16,0
7159,1,-4,-21,-7,3
7160,1,7,6,1,6
7161,1,1,-132,12,-11
7162,1,30,221,13,17
7163,1,0,-25,5,-5
7164,1,35,300,15,20
7165,1,-7,0,0,-7
7166,1,1,-132,-11,12
7167,1,0,-81,-9,9
7168,1,6,-216,18,-12
7169,1,-9,-112,7,-16
7170,1,-29,198,-11,-18
7171,1,-13,30,-3,-10
7172,1,15,-54,18,-3
7173,1,-16,64,-8,-8
7174,1,2,-15,5,-3
7175,1,27,176,11,16
7176,1,-21,80,-16,-5
7177,1,12,32,4,8
7178,1,16,-17,17,-1
7179,1,-12,-160,-20,8
7180,1,-4,-117,9,-13
7181,1,2,-3,3,-1
7182,1,5,-84,-7,12
7183,1,-6,-112,8,-14
7184,1,2,-120,-10,12
7185,1,13,0,0,13
7186,1,10,-171,-9,19
7187,1,0,-256,-16,16
7188,1,0,-25,-5,5
7189,1,-15,44,-4,-11
7190,1,-18,0,0,-18
7191,1,0,-289,17,-17
7192,1,-11,10,-10,-1
7193,1,27,182,13,14
7194,1,-8,0,0,-8
7195,1,5,-66,-6,11
7196,1,-4,3,-1,-3
7197,1,38,360,20,18
7198,1,20,51,3,17
7199,1,-4,4,-2,-2
7200,1,-37,342,-18,-19
7201,1,31,220,11,20
7202,1,16,0,16,0
7203,1,-10,24,-4,-6
7204,1,3,-18,6,-3
7205,1,-14,48,-8,-6
7206,1,9,-220,-11,20
7207,1,19,88,8,11
7208,1,-11,-102,6,-17
7209,1,1,-90,-9,10
7210,1,33,270,15,18
7211,1,-18,0,-18,0
7212,1,-13,22,-11,-2
7213,1,-18,-19,1,-19
7214,1,-39,380,-20,-19
7215,1,21,110,10,11
7216,1,-17,0,0,-17
7217,1,17,-60,-3,20
7218,1,-20,91,-13,-7
7219,1,-10,9,-1,-9
7220,1,15,-76,19,-4
7221,1,16,-80,-4,20
7222,1,0,-196,14,-14
7223,1,-3,-108,9,-12
7224,1,-25,126,-18,-7
7225,1,11,0,11,0
7226,1,3,-154,14,-11
7227,1,-24,95,-5,-19
7228,1,-29,210,-15,-14
7229,1,-5,-50,5,-10
7230,1,-33,260,-13,-20
7231,1,-18,-19,-19,1
7232,1,7,-98,14,-7
7233,1,6,8,2,4
7234,1,5,-50,-5,10
7235,1,31,228,12,19
7236,1,8,-209,19,-11
7237,1,-9,-36,3,-12
7238,1,-26,160,-10,-16
7239,1,2,-288,-16,18
7240,1,11,-126,-7,18
7241,1,-1,-306,-18,17
7242,1,-21,104,-13,-8
7243,1,-6,-112,8,-14
7244,1,-17,60,-5,-12
7245,1,27,170,10,17
7246,1,2,1,1,1
7247,1,-2,-48,-8,6
7248,1,8,16,4,4
7249,1,22,96,6,16
7250,1,29,204,17,12
7251,1,-21,54,-3,-18
7252,1,4,-140,14,-10
7253,1,15,14,1,14
7254,1,8,-9,-1,9
7255,1,-2,-8,-4,2
7256,1,-12,20,-2,-10
7257,1,4,-96,-8,12
7258,1,-15,-16,-16,1
7259,1,-33,270,-15,-18
7260,1,27,176,16,11
7261,1,-7,-228,12,-19
7262,1,-7,-228,-19,12
7263,1,-21,54,-3,-18
7264,1,3,2,1,2
7265,1,-26,153,-9,-17
7266,1,-32,240,-12,-20
7267,1,-24,119,-17,-7
7268,1,-8,-128,8,-16
7269,1,-14,-15,1,-15
7270,1,-9,18,-3,-6
7271,1,21,104,8,13
7272,1,22,72,18,4
7273,1,9,-70,14,-5
7274,1,13,0,0,13
7275,1,-7,6,-6,-1
7276,1,6,-27,9,-3
7277,1,-12,27,-9,-3
7278,1,-29,204,-12,-17
7279,1,-3,-18,3,-6
7280,1,-2,-168,12,-14
7281,1,-23,90,-5,-18
7282,1,6,-40,10,-4
7283,1,-13,-114,-19,6
7284,1,-6,-135,9,-15
7285,1,14,48,6,8
7286,1,1,-110,11,-10
7287,1,35,304,16,19
7288,1,-23,126,-14,-9
7289,1,-3,-88,8,-11
7290,1,16,39,3,13
7291,1,-26,160,-10,-16
7292,1,23,102,6,17
7293,1,29,198,11,18
7294,1,27,170,10,17
7295,1,14,45,9,5
7296,1,-13,-90,-18,5
7297,1,22,120,12,10
7298,1,10,24,6,4
7299,1,12,20,2,10
7300,1,3,-40,-5,8
7301,1,6,-247,19,-13
7302,1,-1,-6,2,-3
7303,1,14,-51,-3,17
7304,1,-2,-3,-3,1
7305,1,-31,228,-12,-19
7306,1,17,30,2,15
7307,1,4,-117,13,-9
7308,1,5,-104,13,-8
7309,1,-17,72,-9,-8
7310,1,-8,-153,9,-17
7311,1,19,34,17,2
7312,1,-32,240,-20,-12
7313,1,-14,33,-3,-11
7314,1,-29,208,-13,-16
7315,1,5,-126,14,-9
7316,1,11,-126,-7,18
7317,1,19,0,19,0
7318,1,-21,108,-9,-12
7319,1,-13,36,-9,-4
7320,1,5,4,1,4
7321,1,23,60,20,3
7322,1,4,-21,-3,7
7323,1,-15,26,-13,-2
7324,1,6,-135,-9,15
7325,1,-21,68,-17,-4
7326,1,14,0,0,14
7327,1,-17,16,-1,-16
7328,1,-15,14,-1,-14
7329,1,-26,153,-9,-17
7330,1,-1,-90,9,-10
7331,1,-26,168,-12,-14
7332,1,9,-190,-10,19
7333,1,-15,44,-11,-4
7334,1,13,-114,19,-6
7335,1,26,133,7,19
7336,1,-20,36,-18,-2
7337,1,-8,0,-8,0
7338,1,26,153,17,9
7339,1,-9,-22,-11,2
7340,1,5,6,2,3
7341,1,17,60,12,5
7342,1,17,-60,20,-3
7343,1,11,28,4,7
7344,1,6,5,1,5
7345,1,-24,128,-8,-16
7346,1,11,-60,-4,15
7347,1,15,14,14,1
7348,1,31,220,20,11
7349,1,-34,289,-17,-17
7350,1,-36,323,-17,-19
7351,1,-3,-154,-14,11
7352,1,7,-60,12,-5
7353,1,-7,-120,8,-15
7354,1,-3,-40,-8,5
7355,1,-6,-247,13,-19
7356,1,18,32,16,2
7357,1,23,60,20,3
7358,1,25,114,19,6
7359,1,-22,117,-9,-13
7360,1,-17,52,-13,-4
7361,1,-22,121,-11,-11
7362,1,-15,56,-7,-8
7363,1,-1,-272,-17,16
7364,1,-12,-45,3,-15
7365,1,2,-15,-3,5
7366,1,38,360,18,20
7367,1,-1,-156,-13,12
7368,1,11,24,3,8
7369,1,0,-400,-20,20
7370,1,14,-51,17,-3
7371,1,-4,-32,-8,4
7372,1,-5,-6,-6,1
7373,1,4,-192,-12,16
7374,1,8,-128,16,-8
7375,1,1,-210,-14,15
7376,1,-9,-220,11,-20
7377,1,6,8,4,2
7378,1,17,52,4,13
7379,1,-18,56,-4,-14
7380,1,-7,-60,5,-12
7381,1,-13,36,-9,-4
7382,1,7,-260,-13,20
7383,1,-12,-160,8,-20
7384,1,7,10,5,2
7385,1,32,240,20,12
7386,1,-12,-64,4,-16
7387,1,8,-9,9,-1
7388,1,-19,-20,-20,1
7389,1,-6,-216,12,-18
7390,1,19,34,2,17
7391,1,13,-114,-6,19
7392,1,0,-196,-14,14
7393,1,-9,-190,10,-19
7394,1,34,280,20,14
7395,1,2,-35,7,-5
7396,1,-1,-6,2,-3
7397,1,20,0,20,0
7398,1,22,85,17,5
7399,1,-20,19,-19,-1
7400,1,-21,110,-11,-10
7401,1,-9,18,-6,-3
7402,1,5,-126,-9,14
7403,1,-1,-110,-11,10
7404,1,-6,-55,5,-11
7405,1,-4,-32,-8,4
7406,1,5,-234,-13,18
7407,1,-18,77,-11,-7
7408,1,-33,270,-15,-18
7409,1,-3,-28,4,-7
7410,1,-29,198,-18,-11
7411,1,14,24,2,12
7412,1,-7,10,-2,-5
7413,1,-7,-78,6,-13
7414,1,-4,0,-4,0
7415,1,-27,162,-9,-18
7416,1,-9,20,-5,-4
7417,1,0,-169,-13,13
7418,1,-8,-180,10,-18
7419,1,-14,13,-1,-13
7420,1,10,-11,-1,11
7421,1,-7,0,-7,0
7422,1,21,20,20,1
7423,1,26,153,17,9
7424,1,-1,-240,15,-16
7425,1,-14,-15,-15,1
7426,1,5,-14,-2,7
7427,1,-27,182,-13,-14
7428,1,23,60,20,3
7429,1,-39,380,-19,-20
7430,1,-39,380,-20,-19
7431,1,-20,19,-19,-1
7432,1,5,-234,-13,18
7433,1,-12,-45,3,-15
7434,1,-5,-176,11,-16
7435,1,0,-225,15,-15
7436,1,-22,120,-12,-10
7437,1,21,110,10,11
7438,1,-5,4,-4,-1
7439,1,8,16,4,4
7440,1,-13,22,-11,-2
7441,1,-18,17,-17,-1
7442,1,-7,-60,-12,5
7443,1,-13,-30,2,-15
7444,1,3,-304,-16,19
7445,1,3,-108,-9,12
7446,1,4,-60,-6,10
7447,1,-6,-55,5,-11
7448,1,-25,154,-11,-14
7449,1,1,-72,-8,9
7450,1,-4,-252,14,-18
7451,1,19,90,9,10
7452,1,-5,-150,-15,10
7453,1,-4,-60,-10,6
7454,1,17,42,3,14
7455,1,-2,-168,12,-14
7456,1,11,-180,20,-9
7457,1,3,-180,15,-12
7458,1,-8,-153,9,-17
7459,1,8,7,7,1
7460,1,3,-208,16,-13
7461,1,-20,96,-12,-8
7462,1,33,260,20,13
7463,1,-23,112,-7,-16
7464,1,6,-16,8,-2
7465,1,-24,140,-14,-10
7466,1,15,56,8,7
7467,1,-14,0,0,-14
7468,1,-21,68,-17,-4
7469,1,-3,-340,17,-20
7470,1,-32,255,-17,-15
7471,1,19,48,16,3
7472,1,-20,91,-13,-7
7473,1,4,-285,-15,19
7474,1,-14,24,-12,-2
7475,1,-11,28,-4,-7
7476,1,24,140,14,10
7477,1,-16,48,-12,-4
7478,1,6,5,5,1
7479,1,1,-12,-3,4
7480,1,22,96,6,16
7481,1,19,48,16,3
7482,1,35,304,19,16
7483,1,-1,-30,5,-6
7484,1,14,24,12,2
7485,1,-20,96,-12,-8
7486,1,-25,144,-16,-9
7487,1,10,-96,16,-6
7488,1,10,-144,18,-8
7489,1,-9,-52,4,-13
7490,1,-21,98,-7,-14
7491,1,20,75,5,15
7492,1,4,-320,20,-16
7493,1,0,-144,-12,12
7494,1,29,180,9,20
7495,1,-8,-48,-12,4
7496,1,-13,-48,3,-16
7497,1,-26,144,-8,-18
7498,1,8,-209,-11,19
7499,1,-18,17,-1,-17
7500,1,10,-119,-7,17
7501,1,-10,-200,-20,10
7502,1,-3,0,0,-3
7503,1,-18,0,0,-18
7504,1,-16,0,-16,0
7505,1,21,110,11,10
7506,1,-30,224,-14,-16
7507,1,-5,-300,15,-20
7508,1,23,120,8,15
7509,1,7,-98,14,-7
7510,1,2,-120,12,-10
7511,1,-18,56,-4,-14
7512,1,-23,126,-14,-9
7513,1,-23,90,-18,-5
7514,1,31,234,18,13
7515,1,5,-300,20,-15
7516,1,-13,0,0,-13
7517,1,-9,-36,-12,3
7518,1,-1,-6,2,-3
7519,1,29,204,12,17
7520,1,36,323,17,19
7521,1,1,-182,-13,14
7522,1,-1,-6,2,-3
7523,1,-10,-119,-17,7
7524,1,-23,132,-11,-12
7525,1,27,152,8,19
7526,1,-4,-320,-20,16
7527,1,-2,-224,-16,14
7528,1,-15,56,-8,-7
7529,1,23,132,12,11
7530,1,-5,-6,1,-6
7531,1,-11,-180,-20,9
7532,1,-30,216,-12,-18
7533,1,6,-135,-9,15
7534,1,-12,-28,-14,2
7535,1,-3,-304,16,-19
7536,1,-7,-78,-13,6
7537,1,16,39,3,13
7538,1,0,-324,18,-18
7539,1,5,-104,13,-8
7540,1,31,234,13,18
7541,1,12,35,5,7
7542,1,18,-19,-1,19
7543,1,23,102,6,17
7544,1,33,260,13,20
7545,1,0,-49,7,-7
7546,1,36,323,19,17
7547,1,-3,-70,-10,7
7548,1,2,-8,-2,4
7549,1,10,-200,-10,20
7550,1,30,209,11,19
7551,1,8,-105,15,-7
7552,1,-16,63,-7,-9
7553,1,9,18,6,3
7554,1,-20,0,0,-20
7555,1,-13,40,-5,-8
7556,1,18,-19,-1,19
7557,1,0,0,0,0
7558,1,-26,153,-9,-17
7559,1,23,132,12,11
7560,1,33,260,13,20
7561,1,-14,24,-12,-2
7562,1,-7,-60,5,-12
7563,1,-9,-112,-16,7
7564,1,5,-176,-11,16
7565,1,-29,180,-9,-20
7566,1,-3,-40,-8,5
7567,1,1,-20,5,-4
7568,1,14,45,5,9
7569,1,16,48,12,4
7570,1,5,-300,20,-15
7571,1,-14,0,0,-14
7572,1,-9,20,-4,-5
7573,1,-20,51,-17,-3
7574,1,18,17,17,1
7575,1,15,0,0,15
7576,1,7,-8,-1,8
7577,1,-10,9,-1,-9
7578,1,1,-182,-13,14
7579,1,-16,15,-15,-1
7580,1,35,306,18,17
7581,1,19,60,15,4
7582,1,24,119,7,17
7583,1,12,-108,-6,18
7584,1,-20,0,-20,0
7585,1,-8,-240,-20,12
7586,1,-24,80,-20,-4
7587,1,12,11,1,11
7588,1,22,72,18,4
7589,1,11,30,5,6
7590,1,-7,-8,1,-8
7591,1,-10,-75,-15,5
7592,1,-18,56,-14,-4
7593,1,-8,-20,2,-10
7594,1,18,65,5,13
7595,1,11,-152,19,-8
7596,1,-2,-143,-13,11
7597,1,15,-76,-4,19
7598,1,-2,0,-2,0
7599,1,-5,-50,-10,5
7600,1,19,0,0,19
7601,1,18,56,4,14
7602,1,-20,75,-15,-5
7603,1,-1,-306,-18,17
7604,1,20,75,15,5
7605,1,-27,176,-11,-16
7606,1,-10,-24,2,-12
7607,1,-27,152,-19,-8
7608,1,20,19,1,19
7609,1,-5,-84,7,-12
7610,1,-8,-153,9,-17
7611,1,6,-16,-2,8
7612,1,8,-128,16,-8
7613,1,10,-24,12,-2
7614,1,-9,8,-8,-1
7615,1,4,-77,11,-7
7616,1,18,0,18,0
7617,1,5,-36,9,-4
7618,1,2,-255,17,-15
7619,1,5,-66,-6,11
7620,1,3,-4,4,-1
7621,1,14,0,0,14
7622,1,2,-99,-9,11
7623,1,-17,70,-7,-10
7624,1,25,156,13,12
7625,1,-9,-112,7,-16
7626,1,1,-110,-10,11
7627,1,23,102,17,6
7628,1,15,0,0,15
7629,1,11,28,4,7
7630,1,-21,80,-5,-16
7631,1,-25,136,-8,-17
7632,1,0,-256,16,-16
7633,1,-4,-252,14,-18
7634,1,-13,22,-2,-11
7635,1,-1,-272,-17,16
7636,1,14,13,1,13
7637,1,-17,72,-9,-8
7638,1,11,10,1,10
7639,1,16,64,8,8
7640,1,-4,0,0,-4
7641,1,-20,96,-8,-12
7642,1,12,11,11,1
7643,1,-27,180,-15,-12
7644,1,-4,-60,-10,6
7645,1,-5,-6,1,-6
7646,1,-13,0,0,-13
7647,1,16,0,0,16
7648,1,-8,-84,-14,6
7649,1,-24,140,-14,-10
7650,1,16,55,11,5
7651,1,16,39,13,3
7652,1,24,135,15,9
7653,1,22,112,14,8
7654,1,-10,24,-6,-4
7655,1,12,-133,19,-7
7656,1,2,-323,19,-17
7657,1,-4,-252,-18,14
7658,1,3,-208,-13,16
7659,1,11,10,10,1
7660,1,23,76,19,4
7661,1,-23,112,-16,-7
7662,1,-2,-3,-3,1
7663,1,-4,3,-1,-3
7664,1,32,256,16,16
7665,1,24,119,17,7
7666,1,-25,150,-15,-10
7667,1,19,48,3,16
7668,1,2,-3,-1,3
7669,1,-31,234,-13,-18
7670,1,-14,-51,3,-17
7671,1,29,180,20,9
7672,1,-26,153,-9,-17
7673,1,-6,-247,13,-19
7674,1,-4,-192,12,-16
7675,1,0,-9,-3,3
7676,1,18,45,3,15
7677,1,-13,42,-7,-6
7678,1,-12,-28,2,-14
7679,1,12,0,0,12
7680,1,-11,-126,-18,7
7681,1,-18,45,-3,-15
7682,1,10,-144,18,-8
7683,1,-27,140,-20,-7
7684,1,-29,180,-9,-20
7685,1,-12,20,-10,-2
7686,1,3,-304,-16,19
7687,1,8,-48,-4,12
7688,1,17,42,3,14
7689,1,0,-9,3,-3
7690,1,-3,-208,-16,13
7691,1,-27,180,-12,-15
7692,1,30,200,20,10
7693,1,-28,171,-9,-19
7694,1,32,255,15,17
7695,1,27,152,19,8
7696,1,-1,-240,-16,15
7697,1,-8,15,-3,-5
7698,1,-39,380,-19,-20
7699,1,-17,72,-8,-9
7700,1,6,-216,18,-12
7701,1,-15,14,-1,-14
7702,1,-6,-40,4,-10
7703,1,15,50,10,5
7704,1,16,-80,20,-4
7705,1,26,153,17,9
7706,1,21,54,18,3
7707,1,0,-289,17,-17
7708,1,-1,-72,-9,8
7709,1,7,-120,15,-8
7710,1,24,80,20,4
7711,1,5,-234,18,-13
7712,1,18,32,16,2
7713,1,-9,-10,1,-10
7714,1,-40,400,-20,-20
7715,1,7,-30,10,-3
7716,1,14,-32,-2,16
7717,1,3,-154,-11,14
7718,1,16,-57,19,-3
7719,1,-13,0,0,-13
7720,1,-31,228,-12,-19
7721,1,33,260,13,20
7722,1,23,132,11,12
7723,1,11,-180,-9,20
7724,1,-20,84,-6,-14
7725,1,12,-45,-3,15
7726,1,14,48,8,6
7727,1,-4,-21,-7,3
7728,1,-28,180,-18,-10
7729,1,-20,19,-1,-19
7730,1,-27,162,-18,-9
7731,1,-2,-143,11,-13
7732,1,-7,12,-3,-4
7733,1,15,-16,16,-1
7734,1,-3,-18,-6,3
7735,1,2,-168,14,-12
7736,1,4,-192,-12,16
7737,1,-1,0,0,-1
7738,1,-2,-15,-5,3
7739,1,30,221,17,13
7740,1,-9,-136,8,-17
7741,1,-7,12,-4,-3
7742,1,-1,-20,4,-5
7743,1,12,32,4,8
7744,1,-10,-11,1,-11
7745,1,-29,204,-17,-12
7746,1,9,-70,-5,14
7747,1,-21,80,-16,-5
7748,1,-7,-78,-13,6
7749,1,10,-119,17,-7
7750,1,-18,32,-16,-2
7751,1,13,-14,14,-1
7752,1,-6,9,-3,-3
7753,1,-10,16,-2,-8
7754,1,-21,98,-14,-7
7755,1,-4,-140,-14,10
7756,1,10,-96,-6,16
7757,1,14,40,4,10
7758,1,-4,0,0,-4
7759,1,26,144,8,18
7760,1,6,-216,18,-12
7761,1,1,-132,12,-11
7762,1,-24,128,-16,-8
7763,1,4,-320,-16,20
7764,1,0,-256,16,-16
7765,1,20,75,5,15
7766,1,-5,-6,1,-6
7767,1,-7,-8,-8,1
7768,1,5,-84,-7,12
7769,1,-3,-54,-9,6
7770,1,31,240,15,16
7771,1,28,195,13,15
7772,1,11,10,10,1
7773,1,3,-340,20,-17
7774,1,-9,-112,-16,7
7775,1,-10,-96,6,-16
7776,1,4,-12,-2,6
7777,1,-20,99,-9,-11
7778,1,5,-234,18,-13
7779,1,1,-132,-11,12
7780,1,-11,18,-2,-9
7781,1,3,-108,12,-9
7782,1,25,156,13,12
7783,1,-3,-18,-6,3
7784,1,16,48,4,12
7785,1,-4,-21,3,-7
7786,1,-26,120,-20,-6
7787,1,-12,35,-7,-5
7788,1,-4,-5,-5,1
7789,1,29,210,14,15
7790,1,-7,-8,1,-8
7791,1,-15,50,-5,-10
7792,1,12,0,12,0
7793,1,-10,25,-5,-5
7794,1,2,-224,16,-14
7795,1,-7,-98,-14,7
7796,1,-7,-98,7,-14
7797,1,10,16,8,2
7798,1,-29,204,-17,-12
7799,1,-27,140,-7,-20
7800,1,20,91,7,13
7801,1,-15,-76,-19,4
7802,1,37,340,20,17
7803,1,25,156,13,12
7804,1,2,-15,5,-3
7805,1,15,50,10,5
7806,1,-6,-91,-13,7
7807,1,31,238,17,14
7808,1,-22,105,-7,-15
7809,1,7,12,3,4
7810,1,27,152,8,19
7811,1,-10,-11,-11,1
7812,1,-19,48,-3,-16
7813,1,-38,360,-20,-18
7814,1,-17,0,0,-17
7815,1,20,84,14,6
7816,1,-19,18,-18,-1
7817,1,-28,187,-11,-17
7818,1,-4,-96,-12,8
7819,1,-11,18,-2,-9
7820,1,-28,180,-10,-18
7821,1,-14,40,-4,-10
7822,1,-30,225,-15,-15
7823,1,5,-14,7,-2
7824,1,7,-144,-9,16
7825,1,-8,0,0,-8
7826,1,-12,36,-6,-6
7827,1,17,16,16,1
7828,1,5,-176,-11,16
7829,1,-13,-90,5,-18
7830,1,-9,-36,3,-12
7831,1,-25,156,-13,-12
7832,1,-13,0,-13,0
7833,1,1,-342,19,-18
7834,1,-12,20,-2,-10
7835,1,-10,21,-7,-3
7836,1,12,-64,-4,16
7837,1,-4,-45,5,-9
7838,1,-5,-50,5,-10
7839,1,12,-13,-1,13
7840,1,9,-70,-5,14
7841,1,0,-100,-10,10
7842,1,4,-221,-13,17
7843,1,-4,-12,-6,2
7844,1,-10,-171,-19,9
7845,1,2,-255,17,-15
7846,1,19,90,10,9
7847,1,-16,15,-1,-15
7848,1,18,32,2,16
7849,1,-32,247,-19,-13
7850,1,3,-40,-5,8
7851,1,1,-42,-6,7
7852,1,-12,-64,4,-16
7853,1,-8,-153,9,-17
7854,1,37,342,18,19
7855,1,-14,13,-13,-1
7856,1,-7,10,-5,-2
7857,1,-19,78,-13,-6
7858,1,-24,140,-14,-10
7859,1,6,-55,-5,11
7860,1,-14,40,-4,-10
7861,1,-21,90,-15,-6
7862,1,-27,152,-8,-19
7863,1,-12,-28,-14,2
7864,1,10,-119,17,-7
7865,1,8,-240,20,-12
7866,1,-4,-5,-5,1
7867,1,-5,-66,6,-11
7868,1,10,-171,19,-9
7869,1,-19,18,-1,-18
7870,1,17,52,13,4
7871,1,5,-266,19,-14
7872,1,23,130,13,10
7873,1,13,-14,-1,14
7874,1,3,2,1,2
7875,1,-3,-54,-9,6
7876,1,5,-300,-15,20
7877,1,-5,-300,15,-20
7878,1,-4,-12,-6,2
7879,1,39,380,19,20
7880,1,-16,-80,-20,4
7881,1,1,-210,15,-14
7882,1,1,-2,2,-1
7883,1,-18,77,-11,-7
7884,1,-14,45,-5,-9
7885,1,35,300,15,20
7886,1,25,114,6,19
7887,1,31,220,11,20
7888,1,26,144,8,18
7889,1,-36,324,-18,-18
7890,1,18,72,6,12
7891,1,0,-196,-14,14
7892,1,30,216,12,18
7893,1,0,-1,1,-1
7894,1,8,16,4,4
7895,1,2,-143,-11,13
7896,1,26,153,17,9
7897,1,-1,-72,-9,8
7898,1,-17,-18,1,-18
7899,1,5,0,0,5
7900,1,7,-8,-1,8
7901,1,6,-16,8,-2
7902,1,-19,0,0,-19
7903,1,28,171,19,9
7904,1,1,-240,16,-15
7905,1,6,-160,16,-10
7906,1,-13,-68,4,-17
7907,1,4,-60,10,-6
7908,1,-22,85,-5,-17
7909,1,12,-85,17,-5
7910,1,-23,126,-14,-9
7911,1,-24,140,-10,-14
7912,1,-1,-30,5,-6
7913,1,-28,160,-8,-20
7914,1,-11,0,0,-11
7915,1,-6,-40,4,-10
7916,1,13,-30,15,-2
7917,1,6,-112,-8,14
7918,1,5,-66,-6,11
7919,1,12,-28,-2,14
7920,1,-21,108,-9,-12
7921,1,13,12,12,1
7922,1,19,84,7,12
7923,1,21,108,12,9
7924,1,32,240,12,20
7925,1,-1,-12,-4,3
7926,1,-1,-72,8,-9
7927,1,6,-27,-3,9
7928,1,-18,45,-3,-15
7929,1,22,96,6,16
7930,1,14,49,7,7
7931,1,-15,14,-14,-1
7932,1,5,6,2,3
7933,1,-10,-24,-12,2
7934,1,14,48,6,8
7935,1,20,96,12,8
7936,1,2,-224,-14,16
7937,1,1,-182,-13,14
7938,1,7,-30,-3,10
7939,1,18,-19,-1,19
7940,1,3,-340,-17,20
7941,1,-7,-18,-9,2
7942,1,-29,180,-9,-20
7943,1,7,-8,-1,8
7944,1,12,20,10,2
7945,1,6,9,3,3
7946,1,0,-9,-3,3
7947,1,6,-280,-14,20
7948,1,-17,-60,3,-20
7949,1,-3,-108,9,-12
7950,1,18,0,18,0
7951,1,-17,0,0,-17
7952,1,6,5,1,5
7953,1,-33,260,-13,-20
7954,1,17,66,6,11
7955,1,-6,-55,5,-11
7956,1,-16,63,-9,-7
7957,1,20,99,11,9
7958,1,15,36,12,3
7959,1,-15,26,-2,-13
7960,1,28,187,11,17
7961,1,-26,153,-9,-17
7962,1,-24,140,-10,-14
7963,1,-4,-96,-12,8
7964,1,10,-144,18,-8
7965,1,-18,-19,-19,1
7966,1,-15,54,-9,-6
7967,1,-12,-160,-20,8
7968,1,-11,0,0,-11
7969,1,21,104,8,13
7970,1,-22,96,-16,-6
7971,1,-16,-36,2,-18
7972,1,-5,-50,-10,5
7973,1,-1,-110,-11,10
7974,1,31,228,12,19
7975,1,14,48,6,8
7976,1,-17,-60,-20,3
7977,1,22,57,19,3
7978,1,20,64,16,4
7979,1,-12,-64,4,-16
7980,1,-19,78,-6,-13
7981,1,-9,-22,2,-11
7982,1,-4,-192,12,-16
7983,1,-4,-320,16,-20
7984,1,-14,33,-3,-11
7985,1,24,128,16,8
7986,1,19,48,16,3
7987,1,-7,-60,5,-12
7988,1,3,-10,5,-2
7989,1,-34,288,-16,-18
7990,1,15,-76,-4,19
7991,1,7,10,2,5
7992,1,-1,-272,16,-17
7993,1,27,170,17,10
7994,1,15,-34,17,-2
7995,1,33,266,14,19
7996,1,0,-400,-20,20
7997,1,10,-56,-4,14
7998,1,10,0,10,0
7999,1,1,-42,-6,7
8000,1,1,-72,-8,9
8001,1,7,-8,8,-1
8002,1,2,-143,13,-11
8003,1,-3,-340,-20,17
8004,1,28,187,11,17
8005,1,21,80,16,5
8006,1,28,192,12,16
8007,1,-20,19,-19,-1
8008,1,14,33,11,3
8009,1,8,12,6,2
8010,1,27,170,17,10
8011,1,4,-12,6,-2
8012,1,-5,-6,-6,1
8013,1,-20,100,-10,-10
8014,1,26,133,7,19
8015,1,-5,-36,-9,4
8016,1,-24,108,-18,-6
8017,1,6,-160,-10,16
8018,1,1,0,1,0
8019,1,1,-2,-1,2
8020,1,19,78,13,6
8021,1,17,52,4,13
8022,1,-13,-48,-16,3
8023,1,-14,48,-6,-8
8024,1,2,-99,11,-9
8025,1,33,266,19,14
8026,1,-19,-20,1,-20
8027,1,8,-9,9,-1
8028,1,14,-95,19,-5
8029,1,3,-154,-11,14
8030,1,1,-20,-4,5
8031,1,-27,170,-10,-17
8032,1,-18,-19,1,-19
8033,1,0,-9,3,-3
8034,1,5,-14,7,-2
8035,1,-11,0,0,-11
8036,1,-6,-216,12,-18
8037,1,4,4,2,2
8038,1,34,285,15,19
8039,1,4,-5,-1,5
8040,1,31,228,19,12
8041,1,1,-20,-4,5
8042,1,10,24,4,6
8043,1,-27,140,-7,-20
8044,1,-6,0,0,-6
8045,1,-1,-56,7,-8
8046,1,1,-2,2,-1
8047,1,7,-228,19,-12
8048,1,-1,-380,19,-20
8049,1,-9,-22,-11,2
8050,1,18,81,9,9
8051,1,-14,49,-7,-7
8052,1,-19,70,-14,-5
8053,1,4,-140,-10,14
8054,1,11,-102,-6,17
8055,1,26,133,19,7
8056,1,-18,32,-2,-16
8057,1,-3,-108,-12,9
8058,1,-1,-156,12,-13
8059,1,3,-18,6,-3
8060,1,-8,-240,12,-20
8061,1,-21,110,-11,-10
8062,1,11,30,6,5
8063,1,6,-280,20,-14
8064,1,-5,6,-2,-3
8065,1,28,196,14,14
8066,1,-25,114,-19,-6
8067,1,-2,-143,-13,11
8068,1,-16,15,-1,-15
8069,1,11,-180,-9,20
8070,1,26,169,13,13
8071,1,3,-238,-14,17
8072,1,-3,-154,11,-14
8073,1,6,-72,12,-6
8074,1,-3,-238,14,-17
8075,1,14,-95,-5,19
8076,1,3,-108,12,-9
8077,1,32,255,15,17
8078,1,-33,272,-16,-17
8079,1,2,-323,-17,19
8080,1,-32,240,-20,-12
8081,1,-2,-48,-8,6
8082,1,-18,-19,1,-19
8083,1,-31,238,-14,-17
8084,1,-11,-26,-13,2
8085,1,-12,-160,8,-20
8086,1,8,-153,-9,17
8087,1,16,-57,-3,19
8088,1,-14,24,-12,-2
8089,1,-24,95,-19,-5
8090,1,-1,-56,-8,7
8091,1,8,12,2,6
8092,1,-13,22,-2,-11
8093,1,4,-117,13,-9
8094,1,-6,-27,3,-9
8095,1,-16,-36,-18,2
8096,1,17,52,13,4
8097,1,13,-140,20,-7
8098,1,-5,-204,12,-17
8099,1,5,-300,20,-15
8100,1,29,208,16,13
8101,1,16,0,0,16
8102,1,-14,45,-9,-5
8103,1,9,14,7,2
8104,1,-11,-152,-19,8
8105,1,19,90,10,9
8106,1,14,-120,20,-6
8107,1,14,33,11,3
8108,1,13,-68,-4,17
8109,1,32,252,18,14
8110,1,9,-112,16,-7
8111,1,17,72,8,9
8112,1,-20,84,-6,-14
8113,1,-27,170,-17,-10
8114,1,-15,26,-13,-2
8115,1,-10,-119,7,-17
8116,1,24,128,8,16
8117,1,-20,99,-9,-11
8118,1,-11,-102,6,-17
8119,1,-12,-133,-19,7
8120,1,-8,-20,2,-10
8121,1,1,-2,-1,2
8122,1,-1,-12,-4,3
8123,1,9,-52,13,-4
8124,1,22,85,17,5
8125,1,20,84,14,6
8126,1,4,-165,15,-11
8127,1,0,-36,-6,6
8128,1,4,-96,-8,12
8129,1,-30,200,-10,-20
8130,1,-2,-143,11,-13
8131,1,2,-80,10,-8
8132,1,-4,3,-3,-1
8133,1,6,-280,-14,20
8134,1,3,2,2,1
8135,1,9,14,7,2
8136,1,-5,-50,-10,5
8137,1,16,63,9,7
8138,1,20,36,18,2
8139,1,-24,140,-10,-14
8140,1,0,-4,2,-2
8141,1,21,20,1,20
8142,1,20,0,0,20
8143,1,29,204,12,17
8144,1,-25,150,-10,-15
8145,1,9,-90,15,-6
8146,1,-10,-171,9,-19
8147,1,-24,128,-8,-16
8148,1,-30,216,-18,-12
8149,1,10,-56,14,-4
8150,1,5,-126,14,-9
8151,1,22,72,4,18
8152,1,-32,255,-17,-15
8153,1,20,96,12,8
8154,1,0,-64,-8,8
8155,1,-2,-99,9,-11
8156,1,-3,-270,-18,15
8157,1,1,-2,2,-1
8158,1,38,360,20,18
8159,1,-5,-126,9,-14
8160,1,-25,126,-7,-18
8161,1,-19,90,-9,-10
8162,1,5,-14,-2,7
8163,1,-25,126,-18,-7
8164,1,-1,-110,10,-11
8165,1,20,75,15,5
8166,1,-2,1,-1,-1
8167,1,-10,16,-2,-8
8168,1,1,-380,-19,20
8169,1,19,70,14,5
8170,1,-17,0,-17,0
8171,1,27,180,15,12
8172,1,11,28,7,4
8173,1,15,0,0,15
8174,1,-17,16,-1,-16
8175,1,-6,-72,6,-12
8176,1,-6,-216,-18,12
8177,1,-11,-80,5,-16
8178,1,-6,-160,10,-16
8179,1,2,-195,15,-13
8180,1,6,-135,15,-9
8181,1,-5,-66,-11,6
8182,1,34,285,19,15
8183,1,-27,182,-13,-14
8184,1,15,-76,19,-4
8185,1,3,2,1,2
8186,1,17,72,8,9
8187,1,13,-30,-2,15
8188,1,-7,0,-7,0
8189,1,15,-16,16,-1
8190,1,-6,-7,1,-7
8191,1,31,238,14,17
8192,1,-14,24,-2,-12
8193,1,-19,78,-6,-13
8194,1,9,-10,10,-1
8195,1,-4,-221,13,-17
8196,1,-5,-150,10,-15
8197,1,-31,220,-11,-20
8198,1,0,-361,-19,19
8199,1,33,272,16,17
8200,1,27,182,14,13
8201,1,-17,0,0,-17
8202,1,33,266,14,19
8203,1,5,-36,9,-4
8204,1,-5,-84,7,-12
8205,1,19,48,3,16
8206,1,27,176,11,16
8207,1,-24,144,-12,-12
8208,1,4,-192,16,-12
8209,1,14,-72,18,-4
8210,1,9,-136,-8,17
8211,1,-35,300,-20,-15
8212,1,-18,0,-18,0
8213,1,-5,-234,13,-18
8214,1,18,80,10,8
8215,1,-13,0,-13,0
8216,1,-7,-30,-10,3
8217,1,-1,-240,-16,15
8218,1,-13,22,-2,-11
8219,1,16,-17,-1,17
8220,1,-10,-119,-17,7
8221,1,14,40,10,4
8222,1,23,112,7,16
8223,1,0,-9,3,-3
8224,1,14,45,9,5
8225,1,-35,300,-15,-20
8226,1,5,-84,12,-7
8227,1,-33,270,-15,-18
8228,1,1,-110,-10,11
8229,1,10,-171,-9,19
8230,1,-17,72,-8,-9
8231,1,11,28,7,4
8232,1,21,90,15,6
8233,1,1,-20,-4,5
8234,1,-7,-198,-18,11
8235,1,-16,55,-5,-11
8236,1,-28,171,-19,-9
8237,1,-21,110,-10,-11
8238,1,-1,-20,4,-5
8239,1,-16,-36,-18,2
8240,1,-19,18,-18,-1
8241,1,33,260,20,13
8242,1,18,56,14,4
8243,1,-6,-55,-11,5
8244,1,-21,90,-6,-15
8245,1,23,60,20,3
8246,1,15,-16,-1,16
8247,1,-11,-42,-14,3
8248,1,10,-119,-7,17
8249,1,0,-81,9,-9
8250,1,-8,-128,8,-16
8251,1,22,57,3,19
8252,1,6,-187,17,-11
8253,1,-14,24,-12,-2
8254,1,-29,198,-18,-11
8255,1,-6,-27,3,-9
8256,1,-7,10,-5,-2
8257,1,-8,-84,-14,6
8258,1,-8,-48,4,-12
8259,1,-3,-154,11,-14
8260,1,30,221,17,13
8261,1,10,-75,-5,15
8262,1,-4,-117,9,-13
8263,1,-9,-10,1,-10
8264,1,-9,20,-5,-4
8265,1,-10,-11,1,-11
8266,1,-8,-33,-11,3
8267,1,-26,120,-6,-20
8268,1,0,-144,12,-12
8269,1,-20,75,-5,-15
8270,1,-18,17,-1,-17
8271,1,-20,91,-13,-7
8272,1,11,30,6,5
8273,1,10,9,9,1
8274,1,-13,22,-2,-11
8275,1,-36,320,-20,-16
8276,1,7,-60,12,-5
8277,1,6,-216,-12,18
8278,1,-9,-190,-19,10
8279,1,15,44,11,4
8280,1,9,-136,-8,17
8281,1,7,-120,15,-8
8282,1,-16,63,-9,-7
8283,1,-26,165,-15,-11
8284,1,-20,99,-11,-9
8285,1,7,-120,15,-8
8286,1,-8,15,-5,-3
8287,1,-2,-99,9,-11
8288,1,-23,132,-11,-12
8289,1,2,-63,9,-7
8290,1,-32,247,-19,-13
8291,1,-19,78,-6,-13
8292,1,14,13,13,1
8293,1,-6,-160,-16,10
8294,1,-4,-165,11,-15
8295,1,-19,84,-12,-7
8296,1,29,208,13,16
8297,1,-2,-120,10,-12
8298,1,22,85,5,17
8299,1,-13,-140,7,-20
8300,1,-6,-247,13,-19
8301,1,8,-84,-6,14
8302,1,10,-39,13,-3
8303,1,-6,-55,5,-11
8304,1,-12,35,-5,-7
8305,1,-9,-136,-17,8
8306,1,-11,-80,5,-16
8307,1,-12,-133,7,-19
8308,1,24,144,12,12
8309,1,-18,77,-7,-11
8310,1,-22,105,-15,-7
8311,1,-7,10,-5,-2
8312,1,0,-225,15,-15
8313,1,-19,60,-15,-4
8314,1,10,-144,18,-8
8315,1,-27,180,-12,-15
8316,1,4,4,2,2
8317,1,-19,60,-15,-4
8318,1,-24,143,-11,-13
8319,1,-5,-14,2,-7
8320,1,-29,190,-19,-10
8321,1,-11,-12,1,-12
8322,1,-31,238,-17,-14
8323,1,0,-169,-13,13
8324,1,-1,-72,-9,8
8325,1,18,65,5,13
8326,1,-35,300,-15,-20
8327,1,-1,-272,-17,16
8328,1,-14,-51,3,-17
8329,1,21,104,13,8
8330,1,-13,-48,3,-16
8331,1,7,12,3,4
8332,1,15,-34,17,-2
8333,1,-1,-272,16,-17
8334,1,34,288,18,16
8335,1,-17,52,-13,-4
8336,1,-17,72,-8,-9
8337,1,2,-24,6,-4
8338,1,-9,-90,-15,6
8339,1,0,-196,14,-14
8340,1,-5,-50,-10,5
8341,1,-29,210,-15,-14
8342,1,4,-60,10,-6
8343,1,12,0,12,0
8344,1,-39,380,-19,-20
8345,1,7,-18,9,-2
8346,1,4,-192,-12,16
8347,1,-12,32,-8,-4
8348,1,-2,-99,9,-11
8349,1,-8,-105,7,-15
8350,1,-13,30,-3,-10
8351,1,3,-208,16,-13
8352,1,-2,-80,8,-10
8353,1,-15,36,-3,-12
8354,1,-9,-220,11,-20
8355,1,28,187,17,11
8356,1,-7,12,-4,-3
8357,1,-5,-150,10,-15
8358,1,11,-42,-3,14
8359,1,-19,34,-2,-17
8360,1,3,2,2,1
8361,1,7,-120,-8,15
8362,1,17,66,6,11
8363,1,-17,52,-4,-13
8364,1,5,-300,-15,20
8365,1,11,-26,-2,13
8366,1,6,-216,-12,18
8367,1,1,-342,19,-18
8368,1,9,-162,-9,18
8369,1,-4,-252,14,-18
8370,1,10,9,1,9
8371,1,26,169,13,13
8372,1,1,-210,-14,15
8373,1,-28,160,-20,-8
8374,1,2,-35,7,-5
8375,1,8,-20,10,-2
8376,1,-2,-323,-19,17
8377,1,-7,-260,-20,13
8378,1,-19,90,-9,-10
8379,1,26,120,6,20
8380,1,6,-280,-14,20
8381,1,9,8,8,1
8382,1,-7,-260,13,-20
8383,1,-8,-153,9,-17
8384,1,-3,-270,-18,15
8385,1,-29,190,-19,-10
8386,1,-19,90,-9,-10
8387,1,4,-252,-14,18
8388,1,-2,-323,17,-19
8389,1,7,-144,-9,16
8390,1,5,-234,-13,18
8391,1,30,224,16,14
8392,1,8,-9,9,-1
8393,1,-15,-100,5,-20
8394,1,-3,2,-1,-2
8395,1,-13,-30,-15,2
8396,1,32,247,13,19
8397,1,9,-190,19,-10
8398,1,19,48,3,16
8399,1,-1,-182,-14,13
8400,1,-4,-252,-18,14
8401,1,-1,-380,-20,19
8402,1,16,-17,-1,17
8403,1,-22,72,-18,-4
8404,1,-10,16,-8,-2
8405,1,1,-240,-15,16
8406,1,-31,240,-15,-16
8407,1,5,-126,-9,14
8408,1,19,70,5,14
8409,1,-7,-44,-11,4
8410,1,-1,-42,6,-7
8411,1,-21,110,-10,-11
8412,1,3,-130,13,-10
8413,1,26,153,17,9
8414,1,10,-96,16,-6
8415,1,0,-289,17,-17
8416,1,1,-12,4,-3
8417,1,-6,-135,9,-15
8418,1,-11,18,-9,-2
8419,1,-11,-126,7,-18
8420,1,13,42,7,6
8421,1,17,60,12,5
8422,1,19,0,0,19
8423,1,5,-266,-14,19
8424,1,2,-120,12,-10
8425,1,-7,-44,4,-11
8426,1,21,110,10,11
8427,1,-25,156,-12,-13
8428,1,-2,-224,14,-16
8429,1,8,-105,-7,15
8430,1,22,72,18,4
8431,1,-4,-165,-15,11
8432,1,16,-80,20,-4
8433,1,-32,256,-16,-16
8434,1,16,0,0,16
8435,1,-9,-136,8,-17
8436,1,-28,192,-16,-12
8437,1,12,-28,-2,14
8438,1,27,140,7,20
8439,1,-21,68,-4,-17
8440,1,13,-140,-7,20
8441,1,20,96,12,8
8442,1,-10,-200,-20,10
8443,1,7,-170,-10,17
8444,1,5,-6,-1,6
8445,1,-28,187,-17,-11
8446,1,-16,-36,2,-18
8447,1,5,-300,-15,20
8448,1,-25,100,-20,-5
8449,1,-3,-304,16,-19
8450,1,-3,-4,1,-4
8451,1,8,-153,17,-9
8452,1,-13,-140,-20,7
8453,1,-12,-85,-17,5
8454,1,-17,42,-3,-14
8455,1,13,-14,-1,14
8456,1,-10,-75,5,-15
8457,1,32,252,18,14
8458,1,-20,51,-17,-3
8459,1,-20,36,-2,-18
8460,1,-24,140,-14,-10
8461,1,-31,240,-15,-16
8462,1,-12,-160,8,-20
8463,1,14,-72,18,-4
8464,1,12,20,2,10
8465,1,2,-24,6,-4
8466,1,4,-60,10,-6
8467,1,7,-44,11,-4
8468,1,12,-45,-3,15
8469,1,-1,-380,19,-20
8470,1,24,108,18,6
8471,1,13,-114,-6,19
8472,1,-11,-80,5,-16
8473,1,-20,36,-18,-2
8474,1,22,57,19,3
8475,1,-3,-28,-7,4
8476,1,6,-16,-2,8
8477,1,-3,-108,-12,9
8478,1,-19,0,0,-19
8479,1,7,-228,19,-12
8480,1,-22,85,-17,-5
8481,1,-19,90,-10,-9
8482,1,13,-68,-4,17
8483,1,3,-40,-5,8
8484,1,11,28,4,7
8485,1,-7,-30,-10,3
8486,1,-31,228,-12,-19
8487,1,20,96,8,12
8488,1,4,-221,17,-13
8489,1,6,0,6,0
8490,1,13,40,8,5
8491,1,-24,119,-17,-7
8492,1,-24,119,-7,-17
8493,1,-2,-288,-18,16
8494,1,4,-60,-6,10
8495,1,9,8,1,8
8496,1,24,108,18,6
8497,1,6,-280,20,-14
8498,1,10,9,9,1
8499,1,14,33,3,11
8500,1,-9,0,0,-9
8501,1,15,50,5,10
8502,1,-10,16,-8,-2
8503,1,-25,156,-12,-13
8504,1,15,-16,-1,16
8505,1,6,-7,-1,7
8506,1,14,45,5,9
8507,1,22,96,16,6
8508,1,9,18,3,6
8509,1,28,171,19,9
8510,1,-9,-22,-11,2
8511,1,-1,-380,-20,19
8512,1,-17,-60,3,-20
8513,1,-8,15,-5,-3
8514,1,33,272,17,16
8515,1,-6,-7,1,-7
8516,1,-6,9,-3,-3
8517,1,1,-132,-11,12
8518,1,-12,-13,-13,1
8519,1,-11,-152,8,-19
8520,1,-8,-33,3,-11
8521,1,4,3,3,1
8522,1,1,-2,-1,2
8523,1,-8,12,-6,-2
8524,1,4,-5,5,-1
8525,1,34,288,18,16
8526,1,4,-32,8,-4
8527,1,9,-36,12,-3
8528,1,-22,57,-3,-19
8529,1,-1,-30,-6,5
8530,1,-27,170,-10,-17
8531,1,22,72,4,18
8532,1,-8,15,-5,-3
8533,1,-19,90,-9,-10
8534,1,-9,-36,-12,3
8535,1,14,40,10,4
8536,1,0,-361,-19,19
8537,1,2,-255,17,-15
8538,1,-16,15,-1,-15
8539,1,12,-45,-3,15
8540,1,-3,0,-3,0
8541,1,-4,-77,-11,7
8542,1,-14,0,-14,0
8543,1,-8,-153,9,-17
8544,1,-9,8,-1,-8
8545,1,21,104,8,13
8546,1,-22,120,-12,-10
8547,1,12,20,10,2
8548,1,-3,2,-1,-2
8549,1,-7,-98,7,-14
8550,1,-23,130,-10,-13
8551,1,-11,-80,-16,5
8552,1,-20,99,-9,-11
8553,1,-5,-14,-7,2
8554,1,17,70,7,10
8555,1,-12,27,-3,-9
8556,1,-20,0,-20,0
8557,1,-20,36,-18,-2
8558,1,1,-2,2,-1
8559,1,-24,80,-20,-4
8560,1,-15,-76,4,-19
8561,1,-13,-14,-14,1
8562,1,7,-78,-6,13
8563,1,5,4,4,1
8564,1,-3,-70,7,-10
8565,1,-5,-14,-7,2
8566,1,5,-36,-4,9
8567,1,4,-165,15,-11
8568,1,23,90,5,18
8569,1,-22,105,-15,-7
8570,1,-1,-30,-6,5
8571,1,-18,77,-7,-11
8572,1,-4,-32,4,-8
8573,1,9,18,6,3
8574,1,20,75,15,5
8575,1,11,28,7,4
8576,1,8,16,4,4
8577,1,-9,-52,-13,4
8578,1,-32,252,-18,-14
8579,1,27,170,17,10
8580,1,6,-55,-5,11
8581,1,-11,-60,-15,4
8582,1,12,-64,-4,16
8583,1,9,0,9,0
8584,1,13,42,6,7
8585,1,-1,-132,-12,11
8586,1,15,-76,-4,19
8587,1,23,132,11,12
8588,1,22,72,4,18
8589,1,27,162,18,9
8590,1,28,195,13,15
8591,1,21,80,5,16
8592,1,-1,-110,10,-11
8593,1,15,-16,16,-1
8594,1,25,114,19,6
8595,1,19,60,4,15
8596,1,-24,119,-7,-17
8597,1,-19,48,-3,-16
8598,1,-13,-30,-15,2
8599,1,13,0,13,0
8600,1,23,112,7,16
8601,1,1,-6,-2,3
8602,1,20,36,2,18
8603,1,-4,-12,-6,2
8604,1,14,-15,-1,15
8605,1,-12,-45,-15,3
8606,1,-13,0,0,-13
8607,1,-7,-228,-19,12
8608,1,5,6,3,2
8609,1,-9,-10,-10,1
8610,1,7,-60,12,-5
8611,1,13,-90,18,-5
8612,1,-17,52,-4,-13
8613,1,4,-5,5,-1
8614,1,-13,22,-2,-11
8615,1,24,144,12,12
8616,1,-4,-320,-20,16
8617,1,-36,324,-18,-18
8618,1,-1,-210,-15,14
8619,1,-6,-72,6,-12
8620,1,19,48,16,3
8621,1,-30,209,-11,-19
8622,1,-18,-19,1,-19
8623,1,29,208,16,13
8624,1,16,39,13,3
8625,1,26,120,20,6
8626,1,10,-96,-6,16
8627,1,16,60,10,6
8628,1,-10,-24,2,-12
8629,1,8,-105,15,-7
8630,1,-11,30,-5,-6
8631,1,5,-66,-6,11
8632,1,23,130,10,13
8633,1,-2,-224,-16,14
8634,1,2,-3,-1,3
8635,1,-10,0,-10,0
8636,1,-18,-40,-20,2
8637,1,7,-170,-10,17
8638,1,-10,-144,-18,8
8639,1,-4,-77,7,-11
8640,1,-22,117,-9,-13
8641,1,-18,32,-2,-16
8642,1,-1,-182,-14,13
8643,1,10,-56,14,-4
8644,1,-27,162,-9,-18
8645,1,-30,224,-14,-16
8646,1,0,-361,-19,19
8647,1,5,6,3,2
8648,1,-20,64,-16,-4
8649,1,-23,60,-20,-3
8650,1,28,180,10,18
8651,1,3,-88,11,-8
8652,1,-6,-40,-10,4
8653,1,16,60,6,10
8654,1,17,60,12,5
8655,1,7,-198,18,-11
8656,1,-3,-88,8,-11
8657,1,-7,-60,-12,5
8658,1,-7,-44,-11,4
8659,1,6,-16,8,-2
8660,1,-15,54,-9,-6
8661,1,34,288,16,18
8662,1,27,140,20,7
8663,1,0,-4,2,-2
8664,1,11,-102,-6,17
8665,1,-1,-72,8,-9
8666,1,-18,80,-8,-10
8667,1,8,-209,19,-11
8668,1,-22,117,-9,-13
8669,1,-15,-16,-16,1
8670,1,19,90,9,10
8671,1,-6,-247,13,-19
8672,1,14,45,9,5
8673,1,-28,192,-12,-16
8674,1,-9,-52,4,-13
8675,1,0,-169,-13,13
8676,1,15,-16,-1,16
8677,1,5,-150,15,-10
8678,1,22,72,18,4
8679,1,-24,119,-17,-7
8680,1,1,-12,-3,4
8681,1,15,-34,17,-2
8682,1,10,-24,-2,12
8683,1,-13,30,-3,-10
8684,1,-20,64,-16,-4
8685,1,5,-150,15,-10
8686,1,-9,-136,-17,8
8687,1,5,-6,-1,6
8688,1,-3,-88,-11,8
8689,1,-18,45,-15,-3
8690,1,21,80,5,16
8691,1,-3,-88,-11,8
8692,1,20,64,16,4
8693,1,26,165,15,11
8694,1,18,56,4,14
8695,1,22,120,12,10
8696,1,-13,-140,7,-20
8697,1,-15,-76,4,-19
8698,1,-13,0,-13,0
8699,1,7,-78,-6,13
8700,1,8,12,2,6
8701,1,-12,-85,5,-17
8702,1,3,-130,13,-10
8703,1,-12,20,-2,-10
8704,1,4,-117,13,-9
8705,1,13,-114,19,-6
8706,1,-22,105,-15,-7
8707,1,-24,144,-12,-12
8708,1,-11,24,-3,-8
8709,1,-6,-280,-20,14
8710,1,7,-144,16,-9
8711,1,-22,96,-16,-6
8712,1,28,171,19,9
8713,1,-13,-90,-18,5
8714,1,-21,110,-10,-11
8715,1,18,0,18,0
8716,1,4,3,3,1
8717,1,14,-32,-2,16
8718,1,21,90,6,15
8719,1,6,-72,-6,12
8720,1,-13,-14,1,-14
8721,1,-8,12,-2,-6
8722,1,4,-320,20,-16
8723,1,-4,-5,-5,1
8724,1,22,105,7,15
8725,1,-12,-133,-19,7
8726,1,-20,84,-6,-14
8727,1,4,-77,-7,11
8728,1,-18,72,-6,-12
8729,1,-28,196,-14,-14
8730,1,10,-11,-1,11
8731,1,-15,50,-10,-5
8732,1,-2,-288,16,-18
8733,1,26,120,6,20
8734,1,16,64,8,8
8735,1,22,96,16,6
8736,1,28,195,15,13
8737,1,-4,-252,14,-18
8738,1,29,208,13,16
8739,1,31,240,16,15
8740,1,-3,-130,10,-13
8741,1,-19,18,-18,-1
8742,1,12,-108,-6,18
8743,1,-12,-13,-13,1
8744,1,-16,-17,1,-17
8745,1,-25,154,-11,-14
8746,1,36,320,16,20
8747,1,-19,18,-1,-18
8748,1,-11,-60,-15,4
8749,1,-12,-28,2,-14
8750,1,14,24,12,2
8751,1,-2,-143,-13,11
8752,1,4,3,3,1
8753,1,4,-252,-14,18
8754,1,-10,-75,5,-15
8755,1,7,0,7,0
8756,1,4,-140,-10,14
8757,1,-1,-210,-15,14
8758,1,-18,65,-5,-13
8759,1,22,57,3,19
8760,1,3,-108,12,-9
8761,1,7,-8,-1,8
8762,1,13,-114,19,-6
8763,1,16,63,9,7
8764,1,-22,40,-20,-2
8765,1,-29,198,-18,-11
8766,1,-9,-190,10,-19
8767,1,28,171,9,19
8768,1,14,45,9,5
8769,1,-33,266,-19,-14
8770,1,-32,247,-19,-13
8771,1,9,18,3,6
8772,1,0,-36,-6,6
8773,1,-11,10,-10,-1
8774,1,24,128,8,16
8775,1,-19,88,-11,-8
8776,1,-29,190,-10,-19
8777,1,15,-100,20,-5
8778,1,-6,-16,-8,2
8779,1,-24,95,-5,-19
8780,1,4,-77,-7,11
8781,1,11,30,5,6
8782,1,9,-112,16,-7
8783,1,30,200,20,10
8784,1,-38,361,-19,-19
8785,1,-7,12,-4,-3
8786,1,3,-340,20,-17
8787,1,-10,-119,-17,7
8788,1,-6,-160,-16,10
8789,1,16,48,4,12
8790,1,-9,8,-8,-1
8791,1,5,-234,18,-13
8792,1,-24,119,-17,-7
8793,1,-38,360,-18,-20
8794,1,-5,-104,8,-13
8795,1,14,-72,-4,18
8796,1,12,-64,-4,16
8797,1,-23,126,-14,-9
8798,1,23,120,8,15
8799,1,0,-225,15,-15
8800,1,-7,-228,-19,12
8801,1,25,114,6,19
8802,1,-14,33,-3,-11
8803,1,-7,-30,-10,3
8804,1,10,0,10,0
8805,1,-9,-70,5,-14
8806,1,21,98,14,7
8807,1,-5,6,-2,-3
8808,1,-17,-38,-19,2
8809,1,14,-51,17,-3
8810,1,-9,-36,-12,3
8811,1,-15,54,-9,-6
8812,1,-3,-304,-19,16
8813,1,-23,126,-14,-9
8814,1,-32,256,-16,-16
8815,1,2,0,2,0
8816,1,9,-90,15,-6
8817,1,-15,-76,-19,4
8818,1,-2,0,-2,0
8819,1,21,38,2,19
8820,1,-15,36,-3,-12
8821,1,-2,-63,-9,7
8822,1,15,-34,17,-2
8823,1,-8,16,-4,-4
8824,1,8,-20,10,-2
8825,1,4,-21,-3,7
8826,1,16,63,7,9
8827,1,20,99,9,11
8828,1,-12,27,-3,-9
8829,1,21,90,6,15
8830,1,26,160,10,16
8831,1,36,324,18,18
8832,1,-15,-54,3,-18
8833,1,-19,18,-1,-18
8834,1,-8,-20,2,-10
8835,1,11,-102,-6,17
8836,1,-5,-234,-18,13
8837,1,-27,180,-15,-12
8838,1,7,-260,20,-13
8839,1,-8,-153,-17,9
8840,1,4,-77,-7,11
8841,1,-15,0,-15,0
8842,1,20,64,4,16
8843,1,16,-36,18,-2
8844,1,-1,-12,-4,3
8845,1,-2,-120,-12,10
8846,1,13,40,5,8
8847,1,10,24,6,4
8848,1,-2,-224,14,-16
8849,1,-10,-75,-15,5
8850,1,-20,36,-18,-2
8851,1,39,380,19,20
8852,1,6,-72,12,-6
8853,1,-21,110,-10,-11
8854,1,-4,-96,8,-12
8855,1,-3,-88,-11,8
8856,1,-20,84,-6,-14
8857,1,7,12,4,3
8858,1,11,30,6,5
8859,1,-5,-266,-19,14
8860,1,31,228,19,12
8861,1,-18,56,-14,-4
8862,1,7,-170,17,-10
8863,1,20,84,14,6
8864,1,11,-26,13,-2
8865,1,19,78,6,13
8866,1,1,-182,-13,14
8867,1,3,-208,16,-13
8868,1,-12,-45,-15,3
8869,1,15,14,14,1
8870,1,8,15,5,3
8871,1,0,-36,-6,6
8872,1,9,14,7,2
8873,1,1,-132,-11,12
8874,1,17,-38,19,-2
8875,1,-20,99,-11,-9
8876,1,23,90,5,18
8877,1,-13,-68,-17,4
8878,1,2,-288,18,-16
8879,1,21,80,5,16
8880,1,5,-104,-8,13
8881,1,1,-306,18,-17
8882,1,-15,14,-14,-1
8883,1,-20,99,-9,-11
8884,1,2,0,2,0
8885,1,-33,270,-18,-15
8886,1,-12,-13,-13,1
8887,1,1,-240,16,-15
8888,1,-13,-140,7,-20
8889,1,-25,156,-12,-13
8890,1,-26,153,-17,-9
8891,1,-19,18,-18,-1
8892,1,0,-289,-17,17
8893,1,-17,-38,-19,2
8894,1,9,8,1,8
8895,1,21,90,6,15
8896,1,9,-10,10,-1
8897,1,2,-255,17,-15
8898,1,19,0,19,0
8899,1,15,36,3,12
8900,1,16,28,14,2
8901,1,-25,136,-17,-8
8902,1,-13,-114,6,-19
8903,1,1,-20,-4,5
8904,1,5,-14,7,-2
8905,1,-1,-56,-8,7
8906,1,-4,-140,10,-14
8907,1,14,33,3,11
8908,1,17,16,16,1
8909,1,18,77,11,7
8910,1,-25,154,-11,-14
8911,1,12,32,4,8
8912,1,-28,160,-8,-20
8913,1,-6,-27,-9,3
8914,1,23,120,8,15
8915,1,31,234,13,18
8916,1,11,0,11,0
8917,1,-20,99,-11,-9
8918,1,1,-306,-17,18
8919,1,-15,36,-12,-3
8920,1,-11,-126,7,-18
8921,1,34,288,16,18
8922,1,16,-36,-2,18
8923,1,9,14,2,7
8924,1,29,210,15,14
8925,1,30,225,15,15
8926,1,17,-38,19,-2
8927,1,-22,96,-16,-6
8928,1,3,0,3,0
8929,1,4,-96,12,-8
8930,1,-33,270,-15,-18
8931,1,-7,-44,4,-11
8932,1,5,-84,12,-7
8933,1,9,-10,-1,10
8934,1,35,306,18,17
8935,1,-7,-78,-13,6
8936,1,9,-190,-10,19
8937,1,0,-4,2,-2
8938,1,-19,60,-4,-15
8939,1,19,18,1,18
8940,1,-22,105,-15,-7
8941,1,17,42,14,3
8942,1,-10,-144,8,-18
8943,1,-16,64,-8,-8
8944,1,16,60,10,6
8945,1,14,13,1,13
8946,1,-14,-15,-15,1
8947,1,27,152,19,8
8948,1,-5,-176,-16,11
8949,1,4,-60,10,-6
8950,1,25,150,10,15
8951,1,35,306,17,18
8952,1,-21,54,-3,-18
8953,1,21,90,15,6
8954,1,3,-10,5,-2
8955,1,25,136,17,8
8956,1,25,136,17,8
8957,1,6,-135,-9,15
8958,1,19,70,14,5
8959,1,-6,-187,-17,11
8960,1,-4,-21,-7,3
8961,1,9,-90,15,-6
8962,1,-15,14,-14,-1
8963,1,13,-140,20,-7
8964,1,30,209,19,11
8965,1,-15,-76,-19,4
8966,1,4,-5,-1,5
8967,1,-20,19,-1,-19
8968,1,23,90,5,18
8969,1,5,-126,-9,14
8970,1,35,304,19,16
8971,1,-2,-15,-5,3
8972,1,-16,15,-15,-1
8973,1,-1,-342,18,-19
8974,1,4,-21,7,-3
8975,1,-9,8,-8,-1
8976,1,-6,-72,-12,6
8977,1,-14,48,-8,-6
8978,1,25,154,11,14
8979,1,7,-144,-9,16
8980,1,-13,22,-11,-2
8981,1,6,-160,16,-10
8982,1,12,20,2,10
8983,1,2,-168,14,-12
8984,1,12,35,7,5
8985,1,-19,78,-13,-6
8986,1,-32,252,-18,-14
8987,1,-8,-105,-15,7
8988,1,31,220,11,20
8989,1,18,-19,-1,19
8990,1,11,-180,20,-9
8991,1,12,32,4,8
8992,1,-11,-102,-17,6
8993,1,-4,-285,15,-19
8994,1,-4,-96,-12,8
8995,1,19,-20,20,-1
8996,1,13,-114,-6,19
8997,1,-3,-208,-16,13
8998,1,-7,-60,5,-12
8999,1,-13,42,-7,-6
9000,1,35,306,17,18
9001,1,-25,144,-9,-16
9002,1,4,-140,-10,14
9003,1,-2,-224,14,-16
9004,1,10,-39,-3,13
9005,1,29,190,19,10
9006,1,-21,108,-12,-9
9007,1,21,90,6,15
9008,1,1,-30,6,-5
9009,1,-5,-6,1,-6
9010,1,7,-260,-13,20
9011,1,14,-51,17,-3
9012,1,4,-45,9,-5
9013,1,-19,88,-8,-11
9014,1,-2,-143,-13,11
9015,1,-20,0,-20,0
9016,1,-16,-36,-18,2
9017,1,-2,-168,-14,12
9018,1,2,-24,6,-4
9019,1,6,5,1,5
9020,1,20,91,7,13
9021,1,15,0,15,0
9022,1,13,12,12,1
9023,1,-8,-180,-18,10
9024,1,-9,-112,-16,7
9025,1,-12,-133,-19,7
9026,1,11,-60,-4,15
9027,1,-2,-63,-9,7
9028,1,-4,-12,-6,2
9029,1,29,204,12,17
9030,1,18,17,17,1
9031,1,11,-102,-6,17
9032,1,-9,-36,3,-12
9033,1,12,0,0,12
9034,1,-3,-28,4,-7
9035,1,15,50,10,5
9036,1,2,-120,-10,12
9037,1,11,-60,-4,15
9038,1,-24,119,-17,-7
9039,1,-5,-6,1,-6
9040,1,28,187,11,17
9041,1,-17,-18,-18,1
9042,1,-11,-12,1,-12
9043,1,-35,306,-17,-18
9044,1,-15,-100,-20,5
9045,1,-27,152,-19,-8
9046,1,12,-13,-1,13
9047,1,-27,152,-19,-8
9048,1,22,117,13,9
9049,1,3,-304,-16,19
9050,1,21,38,2,19
9051,1,-5,-204,12,-17
9052,1,-12,-133,-19,7
9053,1,2,-35,7,-5
9054,1,-20,19,-19,-1
9055,1,12,-133,19,-7
9056,1,-30,200,-10,-20
9057,1,15,54,6,9
9058,1,-40,400,-20,-20
9059,1,20,64,16,4
9060,1,11,-180,20,-9
9061,1,0,-361,-19,19
9062,1,-6,-7,1,-7
9063,1,24,119,17,7
9064,1,1,-156,-12,13
9065,1,-6,-247,13,-19
9066,1,-16,-80,4,-20
9067,1,14,49,7,7
9068,1,-20,19,-1,-19
9069,1,6,-216,-12,18
9070,1,-26,165,-15,-11
9071,1,8,-180,18,-10
9072,1,32,240,20,12
9073,1,-25,154,-14,-11
9074,1,-3,-340,-20,17
9075,1,-17,60,-5,-12
9076,1,33,260,13,20
9077,1,-11,-60,4,-15
9078,1,-10,-96,6,-16
9079,1,0,-324,18,-18
9080,1,0,-121,11,-11
9081,1,4,-252,18,-14
9082,1,-4,-32,4,-8
9083,1,-13,-14,-14,1
9084,1,-8,-48,4,-12
9085,1,10,-75,-5,15
9086,1,-20,36,-2,-18
9087,1,-22,57,-19,-3
9088,1,26,144,8,18
9089,1,0,-169,13,-13
9090,1,-12,-64,4,-16
9091,1,5,-234,18,-13
9092,1,-6,-72,6,-12
9093,1,-13,-68,4,-17
9094,1,-5,-24,3,-8
9095,1,-13,-114,-19,6
9096,1,15,-34,-2,17
9097,1,11,-126,-7,18
9098,1,4,-192,-12,16
9099,1,9,20,5,4
9100,1,18,32,2,16
9101,1,0,-81,-9,9
9102,1,-9,8,-8,-1
9103,1,-18,77,-11,-7
9104,1,-16,39,-3,-13
9105,1,5,4,1,4
9106,1,22,72,18,4
9107,1,-3,-10,-5,2
9108,1,-13,42,-6,-7
9109,1,19,34,2,17
9110,1,-5,-6,-6,1
9111,1,9,-90,-6,15
9112,1,12,0,12,0
9113,1,29,210,14,15
9114,1,10,-171,19,-9
9115,1,-8,-153,-17,9
9116,1,-15,-16,1,-16
9117,1,15,26,2,13
9118,1,13,30,3,10
9119,1,-33,260,-20,-13
9120,1,-1,-342,18,-19
9121,1,1,-156,13,-12
9122,1,36,323,17,19
9123,1,20,19,19,1
9124,1,7,-98,14,-7
9125,1,-2,-3,1,-3
9126,1,-22,117,-9,-13
9127,1,-38,360,-20,-18
9128,1,-2,-224,-16,14
9129,1,36,320,16,20
9130,1,15,0,0,15
9131,1,0,-4,-2,2
9132,1,-1,-132,11,-12
9133,1,-14,33,-3,-11
9134,1,-1,-182,-14,13
9135,1,32,240,12,20
9136,1,4,-12,6,-2
9137,1,10,25,5,5
9138,1,-21,98,-14,-7
9139,1,2,-48,-6,8
9140,1,29,208,16,13
9141,1,-1,-56,7,-8
9142,1,34,289,17,17
9143,1,-10,-119,7,-17
9144,1,30,224,16,14
9145,1,5,6,2,3
9146,1,1,-342,19,-18
9147,1,-14,-51,3,-17
9148,1,-28,180,-10,-18
9149,1,-4,-140,10,-14
9150,1,27,152,8,19
9151,1,3,-10,-2,5
9152,1,25,154,11,14
9153,1,16,55,5,11
9154,1,-16,15,-15,-1
9155,1,1,-182,-13,14
9156,1,-19,78,-13,-6
9157,1,18,72,6,12
9158,1,21,80,16,5
9159,1,-20,64,-16,-4
9160,1,-9,0,-9,0
9161,1,-1,-90,9,-10
9162,1,3,-28,7,-4
9163,1,-14,-95,-19,5
9164,1,12,-85,-5,17
9165,1,9,8,1,8
9166,1,-22,96,-16,-6
9167,1,8,-84,-6,14
9168,1,-24,95,-19,-5
9169,1,21,38,19,2
9170,1,5,0,0,5
9171,1,4,-320,20,-16
9172,1,-8,-20,-10,2
9173,1,26,144,8,18
9174,1,-25,154,-14,-11
9175,1,-1,-30,5,-6
9176,1,-20,91,-13,-7
9177,1,19,90,9,10
9178,1,17,16,1,16
9179,1,-14,45,-9,-5
9180,1,6,-247,-13,19
9181,1,18,32,2,16
9182,1,-4,-21,-7,3
9183,1,18,77,11,7
9184,1,9,8,8,1
9185,1,4,-96,12,-8
9186,1,-4,-60,-10,6
9187,1,8,-105,15,-7
9188,1,-13,22,-11,-2
9189,1,-4,4,-2,-2
9190,1,-4,-320,-20,16
9191,1,-17,72,-8,-9
9192,1,12,-85,-5,17
9193,1,24,140,10,14
9194,1,35,306,17,18
9195,1,3,-28,7,-4
9196,1,25,144,16,9
9197,1,-24,119,-17,-7
9198,1,6,9,3,3
9199,1,-25,126,-18,-7
9200,1,-24,80,-20,-4
9201,1,5,-266,-14,19
9202,1,-36,320,-20,-16
9203,1,25,136,17,8
9204,1,3,-340,20,-17
9205,1,-8,-65,5,-13
9206,1,-2,-143,11,-13
9207,1,2,-360,-18,20
9208,1,-10,-96,-16,6
9209,1,5,-66,11,-6
9210,1,-4,-5,-5,1
9211,1,-34,280,-14,-20
9212,1,9,20,4,5
9213,1,5,-300,-15,20
9214,1,-7,-228,-19,12
9215,1,5,-176,-11,16
9216,1,20,84,6,14
9217,1,-28,195,-13,-15
9218,1,-30,225,-15,-15
9219,1,-15,-54,3,-18
9220,1,-29,180,-9,-20
9221,1,-6,8,-4,-2
9222,1,5,-84,12,-7
9223,1,16,-17,17,-1
9224,1,-20,36,-18,-2
9225,1,-11,10,-10,-1
9226,1,6,-216,-12,18
9227,1,-15,-54,3,-18
9228,1,6,-72,-6,12
9229,1,9,-36,12,-3
9230,1,6,-40,10,-4
9231,1,15,-76,19,-4
9232,1,-28,187,-17,-11
9233,1,30,209,11,19
9234,1,17,66,11,6
9235,1,-16,-17,-17,1
9236,1,5,-104,13,-8
9237,1,20,36,18,2
9238,1,5,-14,-2,7
9239,1,2,-35,7,-5
9240,1,15,14,1,14
9241,1,8,-48,12,-4
9242,1,1,-2,-1,2
9243,1,4,-5,-1,5
9244,1,21,68,17,4
9245,1,-36,323,-17,-19
9246,1,28,187,11,17
9247,1,22,105,7,15
9248,1,2,-15,5,-3
9249,1,-10,-56,4,-14
9250,1,9,-10,-1,10
9251,1,-21,80,-16,-5
9252,1,-2,-48,6,-8
9253,1,14,-15,-1,15
9254,1,-15,-16,-16,1
9255,1,-31,234,-18,-13
9256,1,36,320,16,20
9257,1,15,50,10,5
9258,1,-22,40,-20,-2
9259,1,-18,0,0,-18
9260,1,16,64,8,8
9261,1,10,-39,-3,13
9262,1,-19,84,-12,-7
9263,1,26,165,15,11
9264,1,18,45,3,15
9265,1,-19,34,-17,-2
9266,1,-2,-15,3,-5
9267,1,-3,-70,-10,7
9268,1,13,40,5,8
9269,1,-9,-136,-17,8
9270,1,-7,-98,7,-14
9271,1,-9,-190,10,-19
9272,1,-10,-96,-16,6
9273,1,16,28,14,2
9274,1,7,-8,-1,8
9275,1,-29,208,-13,-16
9276,1,23,130,13,10
9277,1,-17,66,-6,-11
9278,1,-21,38,-19,-2
9279,1,17,16,1,16
9280,1,-18,-19,-19,1
9281,1,18,0,0,18
9282,1,10,-200,20,-10
9283,1,25,154,11,14
9284,1,8,-33,11,-3
9285,1,30,225,15,15
9286,1,18,65,13,5
9287,1,3,-10,-2,5
9288,1,3,-340,-17,20
9289,1,10,-75,15,-5
9290,1,29,210,14,15
9291,1,4,-140,-10,14
9292,1,-19,0,0,-19
9293,1,-19,0,0,-19
9294,1,-25,136,-17,-8
9295,1,-6,-40,-10,4
9296,1,-8,-20,-10,2
9297,1,16,15,1,15
9298,1,23,90,5,18
9299,1,15,0,0,15
9300,1,2,-323,19,-17
9301,1,7,-30,10,-3
9302,1,0,-361,19,-19
9303,1,18,0,18,0
9304,1,-15,-34,-17,2
9305,1,21,108,12,9
9306,1,15,-34,-2,17
9307,1,2,-63,-7,9
9308,1,34,288,16,18
9309,1,-27,140,-7,-20
9310,1,17,72,9,8
9311,1,-15,-100,-20,5
9312,1,-7,-60,5,-12
9313,1,15,14,1,14
9314,1,20,96,12,8
9315,1,26,169,13,13
9316,1,15,-76,-4,19
9317,1,1,-2,-1,2
9318,1,37,340,17,20
9319,1,26,168,12,14
9320,1,23,60,20,3
9321,1,11,-126,18,-7
9322,1,21,104,13,8
9323,1,-11,-152,-19,8
9324,1,17,-60,20,-3
9325,1,22,40,2,20
9326,1,10,-39,13,-3
9327,1,6,-7,7,-1
9328,1,-1,0,-1,0
9329,1,2,0,2,0
9330,1,2,-224,-14,16
9331,1,-5,-150,10,-15
9332,1,-4,-320,16,-20
9333,1,-9,14,-7,-2
9334,1,-9,-22,2,-11
9335,1,-30,221,-17,-13
9336,1,17,-18,18,-1
9337,1,31,228,12,19
9338,1,15,44,4,11
9339,1,-9,0,-9,0
9340,1,23,60,3,20
9341,1,-10,-200,10,-20
9342,1,6,-16,8,-2
9343,1,-3,2,-2,-1
9344,1,31,228,19,12
9345,1,12,32,8,4
9346,1,-15,36,-12,-3
9347,1,-19,84,-7,-12
9348,1,-35,304,-16,-19
9349,1,16,15,15,1
9350,1,22,121,11,11
9351,1,5,-176,16,-11
9352,1,-3,-154,11,-14
9353,1,-4,-252,-18,14
9354,1,22,105,7,15
9355,1,-11,30,-6,-5
9356,1,-9,-52,-13,4
9357,1,-2,-15,3,-5
9358,1,-18,72,-12,-6
9359,1,0,-4,2,-2
9360,1,21,104,13,8
9361,1,-3,-18,3,-6
9362,1,2,-323,-17,19
9363,1,13,0,0,13
9364,1,20,99,9,11
9365,1,-13,40,-5,-8
9366,1,26,153,17,9
9367,1,-19,-20,-20,1
9368,1,28,180,18,10
9369,1,32,247,13,19
9370,1,1,-90,10,-9
9371,1,1,-272,-16,17
9372,1,-35,304,-19,-16
9373,1,4,-96,12,-8
9374,1,-1,-132,11,-12
9375,1,-21,68,-17,-4
9376,1,-19,60,-4,-15
9377,1,-10,24,-6,-4
9378,1,24,135,15,9
9379,1,7,-44,-4,11
9380,1,-16,-17,-17,1
9381,1,-6,-112,8,-14
9382,1,-26,133,-19,-7
9383,1,3,-88,-8,11
9384,1,27,140,7,20
9385,1,3,-70,10,-7
9386,1,-14,-72,4,-18
9387,1,-4,-5,-5,1
9388,1,-34,280,-14,-20
9389,1,6,-112,14,-8
9390,1,6,-91,13,-7
9391,1,17,52,4,13
9392,1,15,50,5,10
9393,1,-13,12,-1,-12
9394,1,-17,30,-2,-15
9395,1,-10,9,-9,-1
9396,1,-2,-3,-3,1
9397,1,-18,0,0,-18
9398,1,-13,-68,4,-17
9399,1,3,-88,11,-8
9400,1,10,-96,16,-6
9401,1,7,-260,-13,20
9402,1,-21,90,-6,-15
9403,1,-11,-126,7,-18
9404,1,19,88,11,8
9405,1,24,119,7,17
9406,1,19,18,1,18
9407,1,6,-7,7,-1
9408,1,22,57,3,19
9409,1,-14,13,-1,-13
9410,1,-22,120,-10,-12
9411,1,-26,133,-7,-19
9412,1,-13,-90,5,-18
9413,1,17,70,7,10
9414,1,-33,266,-19,-14
9415,1,16,15,15,1
9416,1,15,36,3,12
9417,1,9,-10,10,-1
9418,1,-8,-240,12,-20
9419,1,11,-180,20,-9
9420,1,-18,32,-16,-2
9421,1,-24,135,-15,-9
9422,1,24,128,8,16
9423,1,-4,-320,16,-20
9424,1,13,0,0,13
9425,1,-8,12,-6,-2
9426,1,-18,65,-13,-5
9427,1,-1,-30,-6,5
9428,1,-1,-380,19,-20
9429,1,2,-3,-1,3
9430,1,-25,114,-19,-6
9431,1,-4,-77,-11,7
9432,1,2,-195,15,-13
9433,1,3,-130,13,-10
9434,1,1,-72,-8,9
9435,1,-27,182,-13,-14
9436,1,-17,16,-1,-16
9437,1,-1,-90,9,-10
9438,1,-17,70,-7,-10
9439,1,-8,-65,-13,5
9440,1,-32,240,-20,-12
9441,1,-29,198,-18,-11
9442,1,23,90,5,18
9443,1,-9,-36,3,-12
9444,1,-2,-80,8,-10
9445,1,1,-110,-10,11
9446,1,2,-195,15,-13
9447,1,5,-6,-1,6
9448,1,-34,288,-18,-16
9449,1,0,-64,8,-8
9450,1,3,-28,7,-4
9451,1,-10,-96,6,-16
9452,1,-14,24,-12,-2
9453,1,-11,-80,5,-16
9454,1,18,72,12,6
9455,1,-1,-2,-2,1
9456,1,-11,-180,9,-20
9457,1,12,-13,-1,13
9458,1,7,6,1,6
9459,1,-2,-15,3,-5
9460,1,0,-361,-19,19
9461,1,4,-60,10,-6
9462,1,12,35,5,7
9463,1,14,24,2,12
9464,1,2,-24,-4,6
9465,1,10,-144,18,-8
9466,1,15,-54,-3,18
9467,1,2,-24,6,-4
9468,1,-36,324,-18,-18
9469,1,22,72,18,4
9470,1,17,16,1,16
9471,1,19,60,15,4
9472,1,13,-90,-5,18
9473,1,35,300,15,20
9474,1,-2,-99,9,-11
9475,1,2,-99,11,-9
9476,1,16,63,7,9
9477,1,-29,204,-17,-12
9478,1,5,-14,-2,7
9479,1,-17,-38,-19,2
9480,1,-1,-182,13,-14
9481,1,17,72,9,8
9482,1,5,-234,-13,18
9483,1,-18,77,-7,-11
9484,1,-9,20,-4,-5
9485,1,13,36,4,9
9486,1,8,-209,-11,19
9487,1,8,-180,18,-10
9488,1,15,-34,17,-2
9489,1,8,-9,9,-1
9490,1,-6,-112,8,-14
9491,1,3,0,0,3
9492,1,-14,0,0,-14
9493,1,16,-36,-2,18
9494,1,7,-18,9,-2
9495,1,3,-304,19,-16
9496,1,-8,7,-7,-1
9497,1,-18,17,-17,-1
9498,1,-3,-130,-13,10
9499,1,21,104,8,13
9500,1,11,24,8,3
9501,1,23,130,13,10
9502,1,7,-260,-13,20
9503,1,4,-21,-3,7
9504,1,-5,-204,-17,12
9505,1,-2,-224,14,-16
9506,1,4,-165,15,-11
9507,1,13,-14,-1,14
9508,1,-20,96,-12,-8
9509,1,-19,-20,1,-20
9510,1,-13,-14,1,-14
9511,1,-21,108,-9,-12
9512,1,14,33,11,3
9513,1,-10,-11,-11,1
9514,1,-10,-200,10,-20
9515,1,22,112,8,14
9516,1,-1,-210,-15,14
9517,1,18,80,8,10
9518,1,7,6,1,6
9519,1,-11,-102,-17,6
9520,1,-21,110,-10,-11
9521,1,10,-39,13,-3
9522,1,-10,21,-3,-7
9523,1,-20,99,-11,-9
9524,1,16,-36,18,-2
9525,1,-3,-340,17,-20
9526,1,11,-126,18,-7
9527,1,-11,18,-2,-9
9528,1,-38,360,-20,-18
9529,1,7,6,6,1
9530,1,13,-14,14,-1
9531,1,-16,-80,-20,4
9532,1,5,-14,7,-2
9533,1,-12,-28,-14,2
9534,1,-3,-180,12,-15
9535,1,2,-168,14,-12
9536,1,12,36,6,6
9537,1,-22,40,-2,-20
9538,1,6,0,6,0
9539,1,5,6,2,3
9540,1,14,45,9,5
9541,1,1,-342,-18,19
9542,1,28,171,19,9
9543,1,5,4,4,1
9544,1,-10,-39,3,-13
9545,1,-13,30,-3,-10
9546,1,4,-5,-1,5
9547,1,-30,221,-13,-17
9548,1,-22,117,-13,-9
9549,1,-2,-15,3,-5
9550,1,-14,-51,3,-17
9551,1,5,0,5,0
9552,1,-26,153,-9,-17
9553,1,1,-132,12,-11
9554,1,-19,84,-7,-12
9555,1,-10,-11,1,-11
9556,1,30,225,15,15
9557,1,14,-32,16,-2
9558,1,-19,90,-10,-9
9559,1,-14,-95,-19,5
9560,1,13,30,3,10
9561,1,5,-204,17,-12
9562,1,-2,-80,8,-10
9563,1,-15,-16,1,-16
9564,1,-2,-195,-15,13
9565,1,-16,-80,-20,4
9566,1,-35,300,-15,-20
9567,1,2,-63,-7,9
9568,1,3,-238,17,-14
9569,1,24,128,16,8
9570,1,10,9,9,1
9571,1,7,-18,-2,9
9572,1,-30,200,-10,-20
9573,1,18,56,4,14
9574,1,-7,-18,-9,2
9575,1,6,0,0,6
9576,1,-4,-192,-16,12
9577,1,3,-28,-4,7
9578,1,6,-91,13,-7
9579,1,-32,255,-15,-17
9580,1,-22,120,-10,-12
9581,1,22,117,9,13
9582,1,-8,-20,-10,2
9583,1,-18,56,-4,-14
9584,1,-15,44,-4,-11
9585,1,7,-144,-9,16
9586,1,3,-40,-5,8
9587,1,9,-90,-6,15
9588,1,-14,33,-11,-3
9589,1,18,72,12,6
9590,1,-3,-238,14,-17
9591,1,5,0,5,0
9592,1,-15,-100,5,-20
9593,1,4,-12,6,-2
9594,1,-27,170,-17,-10
9595,1,35,304,19,16
9596,1,-23,130,-13,-10
9597,1,-16,28,-2,-14
9598,1,-8,-128,-16,8
9599,1,24,95,5,19
9600,1,-9,-90,-15,6
9601,1,2,-360,20,-18
9602,1,12,27,3,9
9603,1,13,-48,16,-3
9604,1,-5,-14,2,-7
9605,1,28,195,15,13
9606,1,30,209,19,11
9607,1,-16,-36,2,-18
9608,1,12,36,6,6
9609,1,9,0,0,9
9610,1,17,30,15,2
9611,1,-8,16,-4,-4
9612,1,-14,-72,-18,4
9613,1,13,-30,-2,15
9614,1,-1,-2,1,-2
9615,1,9,0,9,0
9616,1,0,-144,12,-12
9617,1,-7,-30,3,-10
9618,1,6,-280,20,-14
9619,1,18,-40,-2,20
9620,1,-17,-18,-18,1
9621,1,-15,-100,5,-20
9622,1,3,0,0,3
9623,1,-24,80,-4,-20
9624,1,-2,-15,3,-5
9625,1,4,-77,11,-7
9626,1,27,162,18,9
9627,1,20,64,16,4
9628,1,-9,-36,-12,3
9629,1,26,120,6,20
9630,1,-28,187,-11,-17
9631,1,25,100,5,20
9632,1,12,-13,13,-1
9633,1,-9,-10,1,-10
9634,1,-11,-60,4,-15
9635,1,-3,-18,-6,3
9636,1,-4,-252,-18,14
9637,1,4,-117,-9,13
9638,1,25,126,18,7
9639,1,-7,-30,-10,3
9640,1,-4,-140,-14,10
9641,1,-9,18,-3,-6
9642,1,-24,119,-17,-7
9643,1,19,34,17,2
9644,1,-29,190,-10,-19
9645,1,-9,-90,-15,6
9646,1,-2,-224,-16,14
9647,1,3,-180,-12,15
9648,1,2,-80,10,-8
9649,1,-2,-8,2,-4
9650,1,6,9,3,3
9651,1,24,108,18,6
9652,1,17,70,7,10
9653,1,-8,-33,-11,3
9654,1,-4,-117,-13,9
9655,1,0,-361,-19,19
9656,1,-12,0,0,-12
9657,1,-13,22,-11,-2
9658,1,-9,18,-6,-3
9659,1,36,323,17,19
9660,1,11,-42,14,-3
9661,1,-16,0,0,-16
9662,1,27,180,12,15
9663,1,26,160,16,10
9664,1,35,304,16,19
9665,1,9,8,1,8
9666,1,11,28,7,4
9667,1,16,0,0,16
9668,1,4,-252,18,-14
9669,1,-28,195,-13,-15
9670,1,-16,15,-1,-15
9671,1,1,-6,3,-2
9672,1,-2,-288,-18,16
9673,1,-13,42,-6,-7
9674,1,-24,119,-7,-17
9675,1,-22,112,-8,-14
9676,1,-16,-80,4,-20
9677,1,-1,-132,-12,11
9678,1,-5,-14,-7,2
9679,1,-1,-240,15,-16
9680,1,0,-49,-7,7
9681,1,25,154,11,14
9682,1,-23,130,-13,-10
9683,1,0,-4,2,-2
9684,1,9,-136,-8,17
9685,1,13,-14,14,-1
9686,1,-2,-323,17,-19
9687,1,9,18,3,6
9688,1,-18,56,-14,-4
9689,1,-3,-108,9,-12
9690,1,-15,26,-13,-2
9691,1,16,64,8,8
9692,1,35,300,20,15
9693,1,11,24,3,8
9694,1,22,40,2,20
9695,1,-8,-65,-13,5
9696,1,0,-400,-20,20
9697,1,4,-165,15,-11
9698,1,13,40,8,5
9699,1,22,117,13,9
9700,1,1,-182,14,-13
9701,1,-1,-182,13,-14
9702,1,2,-24,6,-4
9703,1,-16,-36,-18,2
9704,1,-6,-40,-10,4
9705,1,-7,-170,10,-17
9706,1,12,-13,-1,13
9707,1,22,72,4,18
9708,1,-35,300,-20,-15
9709,1,21,98,14,7
9710,1,13,-30,15,-2
9711,1,-12,0,-12,0
9712,1,-9,-36,-12,3
9713,1,17,52,13,4
9714,1,-33,272,-17,-16
9715,1,-3,-304,-19,16
9716,1,5,-24,8,-3
9717,1,-14,-32,2,-16
9718,1,-6,-187,-17,11
9719,1,24,108,18,6
9720,1,0,-49,-7,7
9721,1,2,-143,13,-11
9722,1,7,-120,-8,15
9723,1,-17,52,-13,-4
9724,1,-5,6,-3,-2
9725,1,-1,-30,5,-6
9726,1,15,56,8,7
9727,1,1,-56,-7,8
9728,1,-4,3,-1,-3
9729,1,-22,117,-9,-13
9730,1,25,100,5,20
9731,1,30,224,16,14
9732,1,18,17,1,17
9733,1,-24,119,-7,-17
9734,1,12,36,6,6
9735,1,-22,57,-19,-3
9736,1,-16,63,-9,-7
9737,1,9,14,7,2
9738,1,-4,-117,9,-13
9739,1,7,-78,-6,13
9740,1,15,26,13,2
9741,1,5,-300,-15,20
9742,1,13,40,5,8
9743,1,-5,-266,-19,14
9744,1,8,7,7,1
9745,1,25,136,8,17
9746,1,-22,120,-10,-12
9747,1,20,51,3,17
9748,1,-2,-99,9,-11
9749,1,12,-45,-3,15
9750,1,13,30,3,10
9751,1,30,216,12,18
9752,1,-10,-200,-20,10
9753,1,-2,-63,7,-9
9754,1,-19,48,-3,-16
9755,1,29,210,15,14
9756,1,23,132,11,12
9757,1,28,187,17,11
9758,1,17,-38,19,-2
9759,1,29,180,9,20
9760,1,-24,95,-19,-5
9761,1,7,-30,-3,10
9762,1,2,-63,9,-7
9763,1,22,96,16,6
9764,1,11,24,3,8
9765,1,3,-304,19,-16
9766,1,19,88,11,8
9767,1,17,72,9,8
9768,1,6,5,5,1
9769,1,-12,20,-10,-2
9770,1,18,-19,-1,19
9771,1,-4,-221,-17,13
9772,1,1,-2,-1,2
9773,1,-19,70,-5,-14
9774,1,-10,-96,-16,6
9775,1,15,-16,16,-1
9776,1,8,-240,20,-12
9777,1,-1,-272,-17,16
9778,1,12,-13,13,-1
9779,1,-34,289,-17,-17
9780,1,15,54,9,6
9781,1,-6,-72,-12,6
9782,1,-19,48,-3,-16
9783,1,-12,35,-7,-5
9784,1,-34,288,-16,-18
9785,1,-11,-60,4,-15
9786,1,-8,-128,8,-16
9787,1,7,-260,20,-13
9788,1,22,105,15,7
9789,1,-8,-240,-20,12
9790,1,0,-400,-20,20
9791,1,-4,-32,4,-8
9792,1,1,-182,14,-13
9793,1,-10,24,-6,-4
9794,1,-13,-90,5,-18
9795,1,0,-16,4,-4
9796,1,10,-56,14,-4
9797,1,30,216,18,12
9798,1,17,16,1,16
9799,1,35,300,15,20
9800,1,33,266,14,19
9801,1,-17,0,-17,0
9802,1,8,-9,-1,9
9803,1,-11,28,-7,-4
9804,1,32,255,17,15
9805,1,24,119,17,7
9806,1,-5,-104,-13,8
9807,1,-2,-80,-10,8
9808,1,10,-75,15,-5
9809,1,-11,-80,-16,5
9810,1,2,-48,-6,8
9811,1,19,0,19,0
9812,1,-13,12,-1,-12
9813,1,-14,13,-13,-1
9814,1,17,30,15,2
9815,1,-33,266,-14,-19
9816,1,-7,-198,-18,11
9817,1,5,0,5,0
9818,1,9,20,4,5
9819,1,-4,-5,-5,1
9820,1,-3,-10,-5,2
9821,1,-3,-304,16,-19
9822,1,13,0,0,13
9823,1,27,176,11,16
9824,1,13,-114,19,-6
9825,1,20,64,4,16
9826,1,-3,-54,-9,6
9827,1,11,10,1,10
9828,1,-11,30,-6,-5
9829,1,-20,99,-9,-11
9830,1,9,-10,-1,10
9831,1,-23,102,-17,-6
9832,1,-38,361,-19,-19
9833,1,11,10,10,1
9834,1,-11,-152,8,-19
9835,1,16,28,14,2
9836,1,25,100,20,5
9837,1,3,-28,7,-4
9838,1,-22,105,-7,-15
9839,1,-17,60,-5,-12
9840,1,1,-240,-15,16
9841,1,-25,150,-10,-15
9842,1,-27,170,-10,-17
9843,1,0,-25,-5,5
9844,1,-29,204,-17,-12
9845,1,-31,220,-20,-11
9846,1,3,-108,12,-9
9847,1,14,-120,-6,20
9848,1,32,252,18,14
9849,1,-8,-105,7,-15
9850,1,3,-28,7,-4
9851,1,-3,-238,-17,14
9852,1,-36,320,-16,-20
9853,1,-4,-45,5,-9
9854,1,19,60,15,4
9855,1,-20,64,-16,-4
9856,1,2,0,2,0
9857,1,12,0,0,12
9858,1,28,160,8,20
9859,1,-28,187,-11,-17
9860,1,13,12,12,1
9861,1,-17,16,-16,-1
9862,1,26,160,16,10
9863,1,4,-77,-7,11
9864,1,-16,-36,-18,2
9865,1,16,48,12,4
9866,1,11,28,4,7
9867,1,0,-49,7,-7
9868,1,13,12,12,1
9869,1,-14,-15,1,-15
9870,1,-36,323,-17,-19
9871,1,25,100,20,5
9872,1,35,306,18,17
9873,1,0,-169,-13,13
9874,1,0,-289,17,-17
9875,1,-3,-304,-19,16
9876,1,-4,-221,13,-17
9877,1,-36,323,-19,-17
9878,1,8,7,7,1
9879,1,-19,88,-11,-8
9880,1,18,56,4,14
9881,1,-2,-120,-12,10
9882,1,-6,-91,7,-13
9883,1,-24,128,-16,-8
9884,1,-12,-45,3,-15
9885,1,-9,-52,-13,4
9886,1,1,-30,6,-5
9887,1,-10,21,-7,-3
9888,1,-7,10,-2,-5
9889,1,5,-84,12,-7
9890,1,-25,150,-15,-10
9891,1,-20,0,0,-20
9892,1,18,80,8,10
9893,1,24,135,15,9
9894,1,-12,-45,-15,3
9895,1,-7,-98,-14,7
9896,1,-2,-120,-12,10
9897,1,-8,-84,-14,6
9898,1,-10,-119,7,-17
9899,1,13,-14,14,-1
9900,1,36,320,20,16
9901,1,9,-52,13,-4
9902,1,1,-210,-14,15
9903,1,8,7,7,1
9904,1,-3,-108,-12,9
9905,1,-17,-60,3,-20
9906,1,7,-78,13,-6
9907,1,-12,0,-12,0
9908,1,21,38,2,19
9909,1,-14,-120,6,-20
9910,1,22,117,13,9
9911,1,-4,-60,-10,6
9912,1,-13,12,-1,-12
9913,1,-8,0,-8,0
9914,1,17,72,9,8
9915,1,2,-323,19,-17
9916,1,18,77,11,7
9917,1,18,-19,-1,19
9918,1,13,12,1,12
9919,1,17,70,10,7
9920,1,-2,1,-1,-1
9921,1,21,80,5,16
9922,1,-1,-2,-2,1
9923,1,0,-36,6,-6
9924,1,25,150,15,10
9925,1,-18,77,-7,-11
9926,1,-22,120,-12,-10
9927,1,7,-18,9,-2
9928,1,22,121,11,11
9929,1,14,-95,-5,19
9930,1,6,-55,-5,11
9931,1,-4,3,-1,-3
9932,1,-11,28,-7,-4
9933,1,8,-9,-1,9
9934,1,12,-28,-2,14
9935,1,0,-16,4,-4
9936,1,2,-63,9,-7
9937,1,-5,-6,-6,1
9938,1,-10,-24,2,-12
9939,1,-4,-60,6,-10
9940,1,7,-170,17,-10
9941,1,-1,-20,-5,4
9942,1,12,-64,16,-4
9943,1,-4,-285,15,-19
9944,1,-19,84,-7,-12
9945,1,14,-120,20,-6
9946,1,-8,-84,-14,6
9947,1,-1,-56,-8,7
9948,1,-21,54,-3,-18
9949,1,28,160,8,20
9950,1,2,-224,-14,16
9951,1,9,-220,-11,20
9952,1,5,-176,16,-11
9953,1,8,-84,-6,14
9954,1,-24,128,-8,-16
9955,1,6,9,3,3
9956,1,16,55,5,11
9957,1,24,140,14,10
9958,1,13,-48,-3,16
9959,1,-23,130,-13,-10
9960,1,29,210,15,14
9961,1,-3,-10,2,-5
9962,1,-16,-80,4,-20
9963,1,-5,-66,-11,6
9964,1,23,120,8,15
9965,1,12,11,1,11
9966,1,1,-380,-19,20
9967,1,-12,0,0,-12
9968,1,11,28,4,7
9969,1,8,7,7,1
9970,1,12,0,0,12
9971,1,15,50,5,10
9972,1,15,-34,17,-2
9973,1,-1,-90,-10,9
9974,1,-27,176,-16,-11
9975,1,6,-16,-2,8
9976,1,-21,90,-15,-6
9977,1,8,-65,13,-5
9978,1,25,100,20,5
9979,1,18,0,0,18
9980,1,30,225,15,15
9981,1,31,228,12,19
9982,1,30,209,11,19
9983,1,17,0,0,17
9984,1,-19,84,-12,-7
9985,1,-6,-55,-11,5
9986,1,-21,90,-15,-6
9987,1,-24,80,-4,-20
9988,1,-21,110,-11,-10
9989,1,33,260,20,13
9990,1,5,-300,20,-15
9991,1,-9,-90,-15,6
9992,1,2,0,2,0
9993,1,-3,-40,-8,5
9994,1,6,-72,-6,12
9995,1,-17,42,-14,-3
9996,1,-23,90,-18,-5
9997,1,22,120,10,12
9998,1,-21,110,-11,-10
9999,1,-13,40,-8,-5
10000,1,3,-18,6,-3
